กชกร	k o t^ ch a k @@ n^
กนก	k a n o k^
กนกฉัตร	k a n o k^ ch a t^
กนกพงศ์	k a n o k^ ph o ng^
กนกวรรณ	k a n o k^ w a n^
กนกอร	k a n o k^ z @@ n^
กนิษฐา	k a n i t^ th aa
กนิษฐ์	k a n i t^
กพล	k a ph o n^
กมล	k a m o n^
กมลชนก	k a m o n^ ch a n o k^
กมลพร	k a m o n^ ph @@ n^
กมลรจน์	k a m o n^ r o t^
กมลวรรณ	k a m o n^ w a n^
กมลเนตร	k a m o n^ n ee t^
กร	k @@ n^
กรกช	k @@ r a k o t^
กรกฎ	k @@ r a k o t^
กรกฏ	k @@ r a k o t^
กรณ์	k @@ n^
กรณ์พงษ์	k @@ n^ ph o ng^
กรธัช	k @@ n^ th a t^
กรพจน์	k @@ n^ ph o t^
กรพัฒน์	k @@ r a ph a t^
กรภพ	k @@ r a ph o p^
กรภัทร์	k @@ r a ph a t^
กรรชัย	k a n^ ch a j^
กรรณภว์	k a n^ ph oo
กรรณาภรณ์	k a n^ n aa ph @@ n^
กรรณิกา	k a n^ n i k aa
กรรณิการ์	k a n^ n i k aa
กรวิกา	k @@ n^ w i k aa
กรวิชญ์	k @@ n^ w i t^
กรวิทย์	k @@ n^ w i t^
กรวีร์	k a r a w ii
กรองทอง	kr @@ ng^ th @@ ng^
กระจ่าง	kr a c aa ng^
กระมล	kr a m o n^
กระแต	kr a t xx
กระแส	kr a s xx
กริช	kr i t^
กรุง	kr u ng^
กรุณา	k a r u n aa
กฤชกนก	kr i t^ k a n o k^
กฤตกร	kr i t^ t a k @@ n^
กฤตฎ์	kr i t^ t a d
กฤตธวัฒน์	kr i t^ t a th a w a t^
กฤตธีรา	kr i t^ t a th ii r aa
กฤตนัย	kr i t^ t a n a j^
กฤตพร	kr i t^ t a ph @@ n^
กฤตภัค	kr i t^ t a ph a k^
กฤตภาศ	kr i t^ t a ph aa t^
กฤตย์	kr i t^
กฤติกา	kr i t^ t i k aa
กฤษ	kr i t^
กฤษกร	kr i t^ s a k @@ n^
กฤษฎา	kr i t^ s a d aa
กฤษฎี	kr i t^ s a d ii
กฤษณัส	kr i t^ s a n a t^
กฤษณา	kr i t^ s a n aa
กฤษณ์	kr i t^
กฤษณ์พรหม	kr i t^ phr o m^
กฤษณ์สิรี	kr i t^ s i r ii
กฤษดา	kr i t^ s a d aa
กฤษดาภรณ์	kr i t^ s a d aa ph @@ n^
กฤษติกา	kr i t^ s a t i k aa
กฤษนะ	kr i t^ s a n a
กฤษมงคล	kr i t^ s a m o ng^ kh o n^
กลศ	kl o t^
กล่อม	kl @@ m^
กล้วย	kl uua j^
กล้านรงค์	kl aa n a r o ng^
กวนอู	k uua n^ z uu
กวางทองน้อย	kw aa ng^ th @@ ng^ n @@ j^
กวิตา	kw i t aa
กวิน	kw i n^
กวินตรา	kw i n^ tr aa
กวินทร์	k a w i n^
กวินนา	kw i n^ n aa
กวี	k a w ii
กวีศักดิ์	k a w ii s a k^
กว้าง	kw aa ng^
กศิญา	k a s i j aa
กษมา	k a s a m aa
กษาปณ์	k a s aa p^
กษิดิ์เดช	k a s i d ee t^
กษิต	k a s i t^
กอบกิจ	k @@ p^ k i t^
กอบกุล	k @@ p^ k u n^
กอบกุลยา	k @@ p^ k u n^ l a j aa
กอบศักดิ์	k @@ p^ s a k^
กอปร	k @@ p^
กอร์ปศักดิ์	k @@ p a s a k^
กังวาลไพร	k a ng^ w aa n^ phr a j^
กังสดาล	k a ng^ s a d aa n^
กัญจนา	k a n^ c a n aa
กัญญกร	k a n^ j a k @@ n^
กัญญา	k a n^ j aa
กัญญาพัชญ์	k a n^ j aa ph a t^
กัญญารัตน์	k a n^ j aa r a t^
กัญญาลักษณ์	k a n^ j aa l a k^
กัญญาวีร์	k a n^ j aa w ii
กัญญ์กุลณัช	k a n^ j k u n^ n a t^
กัญญ์ณรัณ	k a n^ j n^ r a n^
กัณฑ์สิทธิ์	k a n^ s i t^
กัณหา	k a n^ h aa
กัตติกา	k a t^ t i k aa
กันตธีร์	k a n^ t a th ii
กันตพงศ์	k a n^ t a ph o ng^
กันตพัฒน์	k a n^ t a ph a t^
กันตภณ	k a n^ t a ph o n^
กันตวรรณ	k a n^ t a w a n^
กันตะ	k a n^ t a
กันติชา	k a n^ t i ch aa
กันต์	k a n^
กันต์ชนุตม์	k a n^ ch a n u t^
กันต์ดนย์	k a n^ d n^
กันต์พิมุกต์	k a n^ ph i m u k^
กันยรินทร์	k a n^ j a r i n^
กันยวีร์	k a n^ j a w ii
กันยา	k a n^ j aa
กัมพล	k a m^ ph o n^
กัลยกร	k a n^ l a j a k @@ n^
กัลยณัฐ	k a n^ l a j a n a t^
กัลยทรรศน์	k a n^ l a j a th a t^
กัลยา	k a n^ l a j aa
กาจก้อง	k aa t^ k @ ng^
กาญจนา	k aa n^ c a n aa
กาญจนารัตน์	k aa n^ c a n aa r a t^
กาญจน์เกล้า	k aa n^ kl a w^
กาญจ์คนึง	k aa n^ kh a n v ng^
กาญศิริ	k aa n^ s i r i
กานดิศ	k aa n a d i t^
กานตพงศ์	k aa n^ t a ph o ng^
กานต์	k aa n^
กานต์ชนิต	k aa n^ ch a n i t^
กานต์ธีรา	k aa n^ th ii r aa
กานต์นรินทร์	k aa n^ n a r i n^
กานท์	k aa n^
การัญชิดา	k aa r a n^ ch i d aa
การิน	k aa r i n^
การุญ	k aa r u n^
การุณ	k aa r u n^
การเวก	k aa n^ w ee k^
กาเหว่า	k aa w a w^
กำจร	k a m^ c @@ n^
กำชัย	k a m^ ch a j^
กำธน	k a m^ th o n^
กำธร	k a m^ th @@ n^
กำพล	k a m^ ph o n^
กิจจา	k i t^ c aa
กิจมาโนชญ์	k i t^ m aa n oo t^
กิตติ	k i t^ t i
กิตติกร	k i t^ t i k @@ n^
กิตติคุณ	k i t^ t i kh u n^
กิตติชัย	k i t^ t i ch a j^
กิตตินนท์	k i t^ t i n o n^
กิตตินุพงษ์	k i t^ t i n u ph o ng^
กิตติพงศ์	k i t^ t i ph o ng^
กิตติพงษ์	k i t^ t i ph o ng^
กิตติพนธ์	k i t^ t i ph o n^
กิตติพัฒน์	k i t^ t i ph a t^
กิตติพัทธ์	k i t^ t i ph a t^
กิตติพันธ์	k i t^ t i ph a n^
กิตติภัทร	k i t^ t i ph a t^
กิตติมา	k i t^ t i m aa
กิตติยากรณ์	k i t^ t i j aa k @@ n^
กิตติรัตน์	k i t^ t i r a t^
กิตติลักษณ์	k i t^ t i l a k^
กิตติศักดิ์	k i t^ t i s a k^
กิตติ์ลภัส	k i t^ l a ph a t^
กิมฮ้อ	k i m^ h @@
กิลาซู	k i l aa s uu
กิ่งกาญจน์	k i ng^ k aa n^
กิ่งแก้ว	k i ng^ k xx w^
กิ๊บ	k i p^
กิ๊ฟ	k i p^
กีรติ	k ii r a t i
กุณฑีรา	k u n^ th ii r aa
กุณณัฏฐ์	k u n^ n a t^
กุมารทอง	k u m aa n^ th @@ ng^
กุลจิราณัฐ	k u n^ c i r aa n a t^
กุลชนาถ	k u n^ l a ch a n aa t^
กุลชลา	k u n^ l a ch a l aa
กุลธิดา	k u n^ th i d aa
กุลนัดดา	k u l a n a t^ d aa
กุลภา	k u n^ l a ph aa
กุลมาศ	k u n^ l a m aa t^
กุลวัสส์	k u n^ w a t^
กุลวุฒิ	k u l a w u t^
กุลสตรี	k u n^ l a s a tr ii
กุศริน	k u t^ s a r i n^
กุศลหมีเทศริ์	k u s o n^ l a m ii th ee t^
กุสุมาลวตี	k u s u m aa n^ w a j^ t ii
กุหลาบ	k u l aa p^
กุหลาบแดง	k u l aa p^ d xx ng^
กุเทพ	k u th ee p^
กูเฮง	k uu h e ng^
กู้น้อย	k uu n @@ j^
กู้เกียรติ	k uu k iia t^
ก่อ	k @@
ก่อศักดิ์	k @@ s a k^
ก่อเกียรติ	k @@ k iia t^
ก่อแก้ว	k @@ k xx w^
ก้อง	k @@ ng^
ก้องธรณี	k @@ ng^ th @@ r a n ii
ก้องธวัช	k @@ ng^ th a w a t^
ก้องนภา	k @ ng^ n a ph aa
ก้องพลากุลวงศ์	k @@ ng^ phl aa k u n^ l a w o ng^
ก้องภูธร	k @@ ng^ ph uu th @@ n^
ก้องฤกษ์	k @ ng^ r qq k^
ก้องสุรินทร์	k @ ng^ s u r i n^
ก้องเกียรติ	k @@ ng^ k iia t^
ก้องไพร	k @@ ng^ phr a j^
ก้าน	k aa n^
ก้านยาว	k aa n^ j aa w^
ก้าวหน้า	k aa w^ n aa
ก้าวไกล	k aa w^ kl a j^
ขงเบ้ง	kh o ng^ b ee ng^
ขจรศักดิ์	kh a c @@ n^ s a k^
ขจรเดช	kh a c @@ n^ d ee t^
ขนิษฐา	kh a n i t^ th aa
ขยัน	kh a j a n^
ขรรค์ชัย	kh a n^ ch a j^
ขวัญข้าว	khw a n^ kh aa w^
ขวัญจิต	khw a n^ c i t^
ขวัญชัย	khw a n^ ch a j^
ขวัญพิชิต	khw a n^ ph i ch i t^
ขวัญฤดี	khw a n^ r v d ii
ขวัญสรวง	khw a n^ s uua ng^
ขวัญใจ	khw a n^ c a j^
ขวัญไทย	khw a n^ th a j^
ขัตติยะ	kh a t^ t i j a
ขัตติยา	kh a t^ t i j aa
ขันติพงษ์	kh a n^ t i ph o ng^
ขุนทอง	kh u n^ th @@ ng^
ขุนพลน้อย	kh u n^ ph o n^ n @@ j^
ขุนพลเล็ก	kh u n^ ph o n^ l a l e k^
ขุนศึก	kh u n^ s v k^
คงกฤษ	kh o ng^ kr i t^
คงกะพัน	kh o ng^ k a ph a n^
คงศักดิ์	kh o ng^ s a k^
คงเดช	kh o ng^ d ee t^
คฑาวุธ	kh th aa w u t^
คณพันธ์	kh a n a ph a n^
คณวัฒน์	kh a n a w a t^
คณากร	kh a n aa k @@ n^
คณิต	kh a n i t^
คณิตกุล	kh a n i t^ k u n^
คณิน	kh a n i n^
คณิศ	kh a n i t^
คทรีน่า	kh tr ii n aa
คธาวุธ	kh a th aa w u t^
คนธนันท์	kh o n^ th a n a n^
คนองศึก	kh a n o ng^ s v k^
คนัสนันท์	kh a n a t^ s a n a n^
คนางค์	kh a n aa ng^
คนึง	kh a n v ng^
คนึงพิมพ์	kh a n v ng^ ph i m^
คม	kh o m^
คมกฤษ	kh o m^ kr i t^
คมกฤษณ์	kh o m^ kr i t^
คมคาย	kh o m^ kh aa j^
คมทวน	kh o m^ th uua n^
คมพยัคฆ์	kh o m^ ph a j a k^
คมภิญญ์	kh o m^ ph i n^
คมฤทธิ์	kh o m^ r i t^
คมสัน	kh o m^ s a n^
คมเดช	kh o m^ d ee t^
ครรชิต	kh a n^ ch i t^
คริษฐา	khr i t^ th aa
คริส	khr i t^
คริสตัล	khr i s^ t a n^
คริสติน	khr i t^ t i n^
คริสตินา	khr i t^ t i n aa
คริสติน่า	khr i t^ t i n aa
ครูบาคำหล้า	khr uu b aa kh a m^ l aa
ครูบาบุญชุ่ม	khr uu b aa b u n^ ch u m^
ครูมานิตย์	khr uu m aa n i t^
คฤหาสน์	kh a r v h aa t^
คลาวเดีย	khl aa w^ d iia
คล้าย	khl aa j^
ควง	kh uua ng^
ควน	kh uua n^
คะนัง	kh a n a ng^
คะนึงนิจ	kh a n v ng^ n i t^
คัคกิ่งรักส์	kh a k^ k i ng^ r a k^
คัฑลียา	kh a t^ l ii j aa
คัทลียา	kh a t^ th a l ii j aa
คัทลีย์	kh a t^ th a l ii
คามิลล่า	kh aa m i n^ l aa
คาริสา	kh aa r i s aa
คารีนา	kh aa r ii n aa
คาเรน	kh aa r ee n^
คำ	kh a m^
คำผาย	kh a m^ ph aa j^
คำพูน	kh a m^ ph uu n^
คำรณ	kh a m^ r o n^
คำสิงห์	kh a m^ s i ng^
คิม	kh i m^
คิมเบอร์ลี่	kh i m^ b qq l ii
คีรติ	kh ii r a t i
คีรี	kh ii r ii
คีรีศักดิ์	kh ii r ii s a k^
คึกฤทธิ์	kh v k^ r i t^
คืนสิทธิ์	kh vv n^ s i t^
คุณพุ่ม	kh u n^ ph u m^
คุณหญิงทองทิพ	kh u n^ j i ng^ th @@ ng^ th i p^
คุณากร	kh u n aa k @@ n^
คุณาธิป	kh u n aa th i p^
ค่อม	kh @@ m^
งามพรรณ	ng aa m^ ph a n^
จงกลพรรณ	c o ng^ k o n^ l a ph a n^
จงพันธ์	c o ng^ ph a n^
จงรัก	c o ng^ r a k^
จงเจต	c o ng^ c ee t^
จณิสตา	c a n i t^ s a t aa
จตุตถพงศ์	c a t u t a th a ph o ng^
จตุพร	c a t u ph @@ n^
จตุภัทร์	c a t u ph a t^
จตุภูมิ	c a t u ph uu m^
จตุรภัทร	c a t u r a ph a t^
จตุรวิทย์	c a t u r a w i t^
จตุโชค	c a t u ch oo k^
จรณชัย	c a r o n^ n a ch a j^
จรวยพร	c a r uua j^ ph @@ n^
จรัญ	c a r a n^
จรัล	c a r a n^
จรัส	c a r a t^
จรัสพงษ์	c a r a t^ ph o ng^
จรัสพร	c a r a t^ ph @@ n^
จรัสฤทธิ์	c a r a t^ r i t^
จรัสศรี	c a r a t^ s ii
จริญญา	c a r i n^ j aa
จรินทร์พร	c a r i n^ ph @@ n^
จริยา	c a r i j aa
จรีนา	c a r ii n aa
จรูญ	c a r uu n^
จรูญพงศ์	c a r uu n^ ph o ng^
จรูญพันธ์	c a r uu n^ ph a n^
จองชัย	c @@ ng^ ch a j^
จอน	c @@ n^
จอนนี่	c @@ n^ n ii
จอนาตา	c @@ n aa t aa
จอม	c @@ m^
จอมขวัญ	c @@ m^ khw a n^
จอมทอง	c @@ m^ th @@ ng^
จอมโหด	c @@ m^ h oo t^
จอย	c @@ j^
จอห์น	c @@ n^
จอห์นนี่	c @@ n^ n ii
จักรกริช	c a k^ kr i t^
จักรกฤษณ์	c a k^ kr i t^
จักรชัย	c a k^ kr a ch a j^
จักรทิพย์	c a k^ th i p^
จักรธร	c a k^ kr a th @@ n^
จักรพงศ์	c a k^ kr a ph o ng^
จักรพงษ์	c a k^ kr a ph o ng^
จักรพันธุ์	c a k^ kr a ph a n^
จักรพันธ์	c a k^ kr a ph a n^
จักรภพ	c a k^ kr a ph o p^
จักรรินทร์	c a k^ kr a r i n^
จักรัตน์	c a k^ k a r a t^
จักริน	c a k^ k a r i n^
จักรินทร์	c a k^ kr i n^
จักรีวัชร	c a k^ kr ii w a t^ ch a r a
จักษณ์	c a k^
จัง	c a ng^
จัตุรนต์	c a t^ t u r o n^
จันจิรา	c a n^ c i r aa
จันตรี	c a n^ tr ii
จันทนี	c a n^ th a n ii
จันทนีย์	c a n^ th a n ii
จันทรา	c a n^ thr aa
จันทร์	c a n^
จันทร์จิรา	c a n^ c i r aa
จันทร์เพ็ง	c a n^ ph e ng^
จั๊กกะบุ๋ม	c a k^ k a b u m^
จาตุรงค์	c aa t u r o ng^
จาตุรนต์	c aa t u r o n^
จามจุรี	c aa m^ c u r ii
จามรี	c aa m^ r ii
จามิน	c aa m i n^
จามิล่า	c aa m i l aa
จาย	c aa j^
จารุจินต์	c aa r u c i n^
จารุณี	c aa r u n ii
จารุบุตร	c aa r u b u t^
จารุพงศ์	c aa r u ph o ng^
จารุพงษ์	c aa r u ph o ng^
จารุพรรณ	c aa r u ph a n^
จารุพัฒน์	c aa r u ph a t^
จารุวรรณ	c aa r u w a n^
จารุวัฒน์	c aa r u w a t^
จำนง	c a m^ n o ng^
จำนงค์	c a m^ n o ng^
จำรัส	c a m^ r a t^
จำลอง	c a m^ l @@ ng^
จำเนียร	c a m^ n iia n^
จำเริญ	c a m^ r qq n^
จิณณะ	c i n^ n a
จิณภัค	c i n^ ph a k^
จิดา	c i d aa
จิตตาภา	c i t^ t aa ph aa
จิตติ	c i t^ t i
จิตตินันท์	c i t^ t i n a n^
จิตติพจน์	c i t^ t i ph o t^
จิตติมา	c i t^ t i m aa
จิตต์	c i t^
จิตต์ลัดดา	c i t^ l a t^ d aa
จิตต์โสภิณ	c i t^ s oo ph i n^
จิตปัญญา	c i t^ p a n^ j aa
จิตภัสร์	c i t^ t a ph a t^
จิตร	c i t^
จิตรคุปต์	c i t^ tr a kh u p^
จิตรภาณุ	c i t^ tr a ph aa n u
จินดา	c i n^ d aa
จินตนัดดา	c i n^ t a n a t^ d aa
จินตนา	c i n^ t a n aa
จินตหรา	c i n^ t a r aa
จินา	c i n aa
จิมมี่	c i m^ m ii
จิรกิตติ์	c i r a k i t^
จิรดาภา	c i r a d aa ph aa
จิรพงศ์	c i r a ph o ng^
จิรพงษ์	c i r a ph o ng^
จิรภา	c i r a ph aa
จิรวรรณ	c i r a w a n^
จิรวัฒน์	c i r a w a t^
จิรวิชญ์	c i r a w i t^
จิรศักดิ์	c i r a s a k^
จิระ	c i r a
จิระนันท์	c i r a n a n^
จิระพันธิ์	c i r a ph a n^
จิระภาคย์	c i r a ph aa k^
จิระศักดิ์	c i r a s a k^
จิรัชยา	c i r a t^ ch a j aa
จิรัฐชัย	c i r a t^ ch a j^
จิรันดร	c i r a n^ d @@ n^
จิรากร	c i r aa k @@ n^
จิราภา	c i r aa ph aa
จิรายุ	c i r aa j u
จิรายุทธ	c i r aa j u t^
จิรายุส	c i r aa j u t^
จิลล์	c i l^
จิ้งหรีดขาว	c i ng^ r ii t^ kh aa w^
จิ๋ว	c i w^
จีรนันท์	c ii r a n a n^
จีรวัลย์	c ii r a w a n^
จีระ	c ii r a
จีระนันท์	c ii r a n a n^
จีระพันธ์	c ii r a ph a n^
จีระศักดิ์	c ii r a s a k^
จุฑาทิพย์	c u th aa th i p^
จุฑาธิป	c u th aa th i p^
จุฑาพิชญ์	c u th aa ph i t^
จุฑาภัทร	c u th aa ph a t^
จุฑามาศ	c u th aa m aa t^
จุฑารัตน์	c u th aa r a t^
จุฑาวุฒิ	c u th aa w u t^
จุติ	c u t^ t i
จุมพฏ	c u m^ ph o t^
จุมพล	c u m^ ph o n^
จุรินทร์	c u r i n^
จุรี	c u r ii
จุฤทธิ์	c u r i t^
จุล	c u n^
จุลจักร	c u n^ l a c a k^
จุลพันธ์	c u n^ l a ph a n^
จุฬาลักษณ์	c u l aa l a k^
จุไรรัตน์	c u r a j^ r a t^
จุ๊กกรู	c u k^ kr uu
จุ๊ย	c u j^
จุ๋มจิ๋ม	c u m^ c i m^
จุ๋ย	c u j^
จูล่ง	c uu l oo ng^
จูหลิง	c uu l i ng^
จูเลี่ยม	c uu l iia m^
จเด็จ	c a d e t^
จ่าง	c aa ng^
จ้อย	c @@ j^
จ้าวสิงห์ทอง	c aa w^ s i ng^ th @@ ng^
จ๊อกกี้	c @@ k^ k ii
จ๊อบ	c @@ p^
ฉมวกเพชร	ch a m uua k^ ph e t^
ฉลอง	ch a l @@ ng^
ฉลองภพ	ch a l @@ ng^ ph o p^
ฉลาด	ch a l aa t^
ฉลามดำ	ch a l aa m^ d a m^
ฉวีวรรณ	ch a w ii w a n^
ฉัฏฐพงศ์	ch a t^ th a ph o ng^
ฉัฐวัสส์	ch a t^ w a t^
ฉัตรชัย	ch a t^ ch a j^
ฉัตรฑริกา	ch a t^ th a r i k aa
ฉัตรพันธ์	ch a t^ ph a n^
ฉัตรสุดา	ch a t^ s u d aa
ฉัตรเพชร	ch a t^ ph ee t^
ฉัตร์ชัย	ch a t^ ch a j^
ฉันทนา	ch a n^ th a n aa
ฉันทวิชช์	ch a n^ th a w i t^
ฉายนันทน์	ch aa j^ n a n^
ฉิ้น	ch i n^
ชญาณิศา	ch a j aa n i s aa
ชญาดา	ch a j aa d aa
ชญานิษฐ์	ch a j aa n i t^
ชญานุช	ch a j aa n u t^
ชญาวัต	ch a j aa w a t^
ชฎาพร	ch a d aa ph @@ n^
ชดช้อย	ch o t^ ch @@ j^
ชนกวนันท์	ch a n o k^ w a n a n^
ชนกสุดา	ch a n o k^ s u d aa
ชนกันต์	ch o n^ k a n^
ชนนภัทร	ch o n^ n a n a ph a t^
ชนะ	ch a n a
ชนะชัย	ch a n a ch a j^
ชนะพล	ch a n a ph o n^
ชนัญญา	ch a n a n^ j aa
ชนัตถ์	ch a n a t^
ชนัท	ch a n a t^
ชนันภรณ์	ch a n a n^ ph @@ n^
ชนาธิป	ch a n aa th i p^
ชนานันท์	ch a n aa n a n^
ชนาพัทธ์	ch a n aa ph a t^
ชนิกา	ch a n i k aa
ชนิดา	ch a n i d aa
ชนิดาภา	ch a n i d aa ph aa
ชนินทร์	ch a n i n^
ชนิสาร์	ch a n i s aa
ชบ	ch o p^
ชมพู	ch o m^ ph uu
ชมพูนุช	ch o m^ ph uu n u t^
ชมพู่	ch o m^ ph uu
ชมะนันทน์	ch a m a n a n^
ชมัยภร	ch a m a j^ ph @@ n^
ชยกร	ch a j a k @@ n^
ชยธร	ch a j oo th @@ n^
ชยนพ	ch a j^ n o p^
ชยพล	ch o j^ ph o n^
ชยพัทธ์	ch o j^ ph a t^
ชยาภา	ch a j aa ph aa
ชยุต	ch a j u t^
ชยุตม์	ch a j u t^
ชรินทร์	ch a r i n^
ชรินรัตน์	ch a r i n^ r a t^
ชล	ch o n^
ชลทิตย์	ch o n^ th i t^
ชลธร	ch o n^ th @@ n^
ชลธาร	ch o n^ l a th aa n^
ชลธิชา	ch o n^ th i ch aa
ชลธี	ch o n^ th ii
ชลนสร	ch o n^ n @@ s @@ n^
ชลน่าน	ch o n^ n aa n^
ชลลดา	ch o n^ l a d aa
ชลวิทย์	ch o n^ l a w i t^
ชลอ	ch a l @@
ชลัฏ	ch a l a t^
ชลาทิศ	ch a l aa th i t^
ชลาศัย	ch a l aa s a j^
ชลิดา	ch a l i d aa
ชลิต	ch a l i t^
ชลิตรัตน์	ch a l i t^ t a r a t^
ชลิตา	ch a l i t aa
ชลูด	ch a l uu t^
ชวกิจ	ch a w a k i t^
ชวน	ch uua n^
ชวนนท์	ch uua n^
ชวนภ	ch uua n^ p^
ชวรัตน์	ch a w a r a t^
ชวลิต	ch a w a l i t^
ชวัลนันท์	ch a w a n^ n a n^
ชวเลิศ	ch a w a l qq t^
ชอุ่ม	ch a z u m^
ชัจจ์	ch a t^
ชัชชม	ch a t^ ch o m^
ชัชชวิศ	ch a t^ ch a w i t^
ชัชชัย	ch a t^ ch a j^
ชัชชาติ	ch a t^ ch aa t^
ชัชชุอร	ch a t^ ch u z @@ n^
ชัชฎาภรณ์	ch a t^ ch a d aa ph @@ n^
ชัชวาล	ch a t^ ch a w aa n^
ชัชวาลย์	ch a t^ ch a w aa n^
ชัญญา	ch a n^ j aa
ชัญษร	ch a n^ s @@ n^
ชัย	ch a j^
ชัยกร	ch a j^ j a k @@ n^
ชัยชนะ	ch a j^ ch a n a
ชัยชาญ	ch a j^ ch aa n^
ชัยณรงค์	ch a j^ n a r o ng^
ชัยนนท์	ch a j^ n o n^
ชัยนันท์	ch a j^ n a n^
ชัยภักดิ์	ch a j^ ph a k^
ชัยยง	ch a j^ j o ng^
ชัยยงค์	ch a j^ j o ng^
ชัยยะ	ch a j^ j a
ชัยยุทธ	ch a j^ j u t^
ชัยรัตน์	ch a j^ r a t^
ชัยฤทธิ์	ch a j^ r i t^
ชัยลดล	ch a j^ l a d o n^
ชัยวัฒน์	ch a j^ w a t^
ชัยวุฒิ	ch a j^ w u t^
ชัยศักดิ์	ch a j^ s a k^
ชัยสิทธิ์	ch a j^ s i t^
ชัยอนันต์	ch a j^ z a n a n^
ชัยเกษม	ch a j^ k a s ee m^
ชัยเดช	ch a j^ j a d ee t^
ชาคร	ch aa kh @@ n^
ชาคริต	ch aa khr i t^
ชาช่า	ch aa ch aa
ชาญ	ch aa n^
ชาญชล	ch aa n^ ch o n^
ชาญชัย	ch aa n^ ch a j^
ชาญณรงค์	ch aa n^ n a r o ng^
ชาญวิทย์	ch aa n^ w i t^
ชาญเดช	ch aa n^ d ee t^
ชาดา	ch aa d aa
ชาตรี	ch aa tr ii
ชาติ	ch aa t^
ชาติชาย	ch aa t^ ch aa j^
ชาติวุฒิ	ch aa t^ t i w u t^
ชาติศิริ	ch aa t^ s i r i
ชานน	ch aa n o n^
ชานนท์	ch aa n o n^
ชานิศา	ch aa n i s aa
ชาย	ch aa j^
ชายธง	ch aa j^ th o ng^
ชาราฎา	ch aa a d aa
ชาริล	ch aa r i n^
ชาละวัน	ch aa l a w a n^
ชาลิดา	ch aa l i d aa
ชาลิตา	ch aa l i t aa
ชาลิสา	ch aa l i s aa
ชาลี	ch aa l ii
ชาวดี	ch aa w a d ii
ชาเคอลีน	ch aa kh qq l ii n^
ชำนาญ	ch a m^ n aa n^
ชำนิ	ch a m^ n i
ชิงชัย	ch i ng^ ch a j^
ชิชา	ch i ch aa
ชิดจันทร์	ch i t^ c a n^
ชิดชนก	ch i t^ ch a n o k^
ชิดชัย	ch i t^ ch a j^
ชิต	ch i t^
ชิตพร	ch i t^ t a ph @@ n^
ชิตพล	ch i t^ ph o n^
ชิติพัทธ์	ch i t i ph a t^
ชิน	ch i n^
ชินกร	ch i n^ n a k @@ n^
ชินชัย	ch i n^ ch a j^
ชินณิชา	ch i n^ n a n i ch aa
ชินภัทร	ch i n^ n a ph a t^
ชินมิษ	ch i n^ n a m i t^
ชินวรณ์	ch i n^ w @@ n^
ชินวัฒน์	ch i n^ n a w a t^
ชินวุฒ	ch i n^ w u t^
ชินวุธ	ch i n^ w u t^
ชินารดี	ch i n aa n^ d ii
ชิบ	ch i p^
ชิษณุชา	ch i t^ s a n u ch aa
ชีรณัฐ	ch ii r a n a t^
ชื่นชอบ	ch vv n^ ch @@ p^
ชุดาภา	ch u d aa ph aa
ชุติกาญจน์	ch u t i k aa n^
ชุติพนธ์	ch u t i ph o n^
ชุติมณฑน์	ch u t i m o n^ th a j^
ชุติมา	ch u t i m aa
ชุบ	ch u p^
ชุมนุม	ch u m^ n u m^
ชุมพร	ch u m^ ph @@ n^
ชุมพล	ch u m^ ph o n^
ชุลีพร	ch u l ii ph @@ n^
ชุษณะ	ch u t^ s a n a
ชูกัน	ch uu k a n^
ชูชัย	ch uu ch a j^
ชูชาติ	ch uu ch aa t^
ชูชีพ	ch uu ch ii p^
ชูพงษ์	ch uu ph o ng^
ชูวงศ์	ch uu w o ng^
ชูวิทย์	ch uu w i t^
ชูศักดิ์	ch uu s a k^
ชูเกียรติ	ch uu k iia t^
ชูเชิด	ch uu ch qq t^
ชเนษฏ์ผกา	ch a n ee t^ ph a k aa
ชโลธร	ch a l oo th @@ n^
ชไมพร	ch a m a j^ ph @@ n^
ช่วง	ch uua ng^
ช่อ	ch @@
ช่อฟ้า	ch @@ f aa
ช้างเผือก	ch aa ng^ ph vva k^
ซอนญ่า	s @@ n^ j aa
ซอนย่า	s @@ n^ n a j aa
ซะการีย์ยา	s a k aa r ii j aa
ซัดดัม	s a t^ d a m^
ซันนี่	s a n^ n ii
ซัลดี้	s a n^ d ii
ซากีรีน	s aa k ii r ii n^
ซาซ่า	s aa s aa
ซานดร้า	s aa n^ dr aa
ซารีฟ	s aa r ii f^
ซาร่า	s aa r aa
ซาแมนต้า	s aa m xx n^ t aa
ซาไก	s aa k a j^
ซินดี้	s i n^ d ii
ซินตึ๊ง	s i n^ t v ng^
ซินบี	s i n^ b ii
ซิลวีโอ	s i n^ w ii z oo
ซีอุย	s ii z u j^
ซีแนม	s ii n xx m^
ซุปเปอร์บอน	s u p^ p qq b @@ n^
ซุปเปอร์แบงค์	s u p^ p qq b xx ng^
ซูการ์โน	s uu k aa n oo
ฌอร์ลชัญ	ch @@ n^ ch a n^
ฌอห์ณ	ch @@ n^
ฌัชฌา	ch a t^ ch aa
ญดา	j a d aa
ญาณกวี	j aa n^ n a k a w ii
ญาณิกา	j aa n i k aa
ญาณิน	j aa n i n^
ญาดา	j aa d aa
ญาติ	j aa t^
ญารินดา	j aa r i n^ d aa
ฐกฤต	th a kr i t^
ฐนิชา	th a n i ch aa
ฐปณีย์	th o p^ p a n ii
ฐปนัท	th o p^ p a n a t^
ฐรินดา	th a z^0 r i n^ d aa
ฐสิษฐ์	th a s i t^
ฐากร	th aa k @@ n^
ฐากูร	th aa k uu n^
ฐานัฐพ์	th aa n a t^
ฐานิสร์	th aa n i t^
ฐาปไพพรรณ	th aa p a ph a j^ ph a n^
ฐิฏา	th i d aa
ฐิตา	th i t aa
ฐิติ	th i t i
ฐิติชล	th i t i ch o n^
ฐิตินันท์	th i t i n a n^
ฐิติพงศ์	th i t i ph o ng^
ฐิติพันธ์	th i t i ph a n^
ฐิติภูมิ	th i t i ph uu m^
ฐิติมา	th i t i m aa
ฐิภารินทร์	th i ph aa r i n^
ฑิฆัมพร	th i kh a m^ ph @@ n^
ฑิชาญา	th i ch aa j aa
ณกุณฑ์	n a k u n^
ณฉัตร	n a ch a t^
ณฐณพ	n a th a n o p^
ณฐพร	n a th a ph @@ n^
ณธกร	n a th a k @@ n^
ณธฤษภ์	n a th a r i
ณธษา	n a th a s aa
ณปภพ	n a p a ph o p^
ณปภัช	n a p a ph a t^
ณปภา	n a p a ph aa
ณพ	n o p^
ณพสิทธิ์	n o p^ s i t^
ณพอาภา	n o p^ z aa ph aa
ณภศศิ	n a ph a s a s i
ณภัทร	n a ph a t^
ณภัสวรรณ	n a ph a t^ s a w a n^
ณรงค์	n a r o ng^
ณรงค์ชัย	n a r o ng^ ch a j^
ณรงค์น้อย	n a r o ng^ n @@ j^
ณรงค์พันธ์	n a r o ng^ ph a n^
ณรงค์ศักดิ์	n a r o ng^ s a k^
ณรงค์ศิลป์	n a r o ng^ s i n^
ณรงค์เดช	n a r o ng^ d ee t^
ณรงค์เลิศ	n a r o ng^ l qq t^
ณรรลฌา	n a n^ l ch aa
ณราชัย	n a r aa ch a j^
ณริฎษาพัชร	n a r i t^ s aa ph a t^ ch a r a
ณฤมล	n a r v m o n^
ณวัชร์	n a z^0 w a t^
ณวัฒน์	n a w a t^
ณหทัย	n a h a th a j^
ณัชชา	n a t^ ch aa
ณัชพล	n a t^ ch a ph o n^
ณัชพัณณ์	n a t^ ch a ph a n^
ณัฎฐา	n a t^ th aa
ณัฎฐ์	n a t^ th
ณัฏฐกันย์	n a t^ th a k a n^
ณัฏฐณิชา	n a t^ th a n i ch aa
ณัฏฐพงษ์	n a t^ th a ph o ng^
ณัฏฐพล	n a t^ th a ph o n^
ณัฏฐพัชร	n a t^ th a ph a t^ ch a r a
ณัฏฐา	n a t^ th aa
ณัฏฐ์	n a t^
ณัฐ	n a t^
ณัฐกานต์	n a t^ th a k aa n^
ณัฐจารี	n a t^ th a c aa r ii
ณัฐชยกานต์	n a t^ ch a j a k aa n^
ณัฐชา	n a t^ ch aa
ณัฐฐชาช์	n a t^ th a ch aa
ณัฐฐานันท์	n a t^ th aa n a n^
ณัฐณิชา	n a t^ th a n i ch aa
ณัฐธยาน์	n a t^ th a j aa
ณัฐธิชา	n a t^ th i ch aa
ณัฐธิดา	n a t^ th a th i d aa
ณัฐนนท์	n a t^ n o n^
ณัฐนันท์	n a t^ th a n a n^
ณัฐนิชา	n a t^ n i ch aa
ณัฐนิดา	n a t^ n i d aa
ณัฐพงษ์	n a t^ th a ph o ng^
ณัฐพนธ์	n a t^ ph o n^
ณัฐพร	n a t^ th a ph @@ n^
ณัฐพล	n a t^ th a ph o n^
ณัฐพัฒน์	n a t^ th a ph a t^
ณัฐพิมล	n a t^ th a ph i m o n^
ณัฐภัทร	n a t^ th a ph a t^
ณัฐภัสสร	n a t^ th a ph a t^ s @@ n^
ณัฐมน	n a t^ th a m o n^
ณัฐรดา	n a t^ th a r a d aa
ณัฐรัฐ	n a t^ th a r a t^
ณัฐริกา	n a t^ th a r i k aa
ณัฐรุจา	n a t^ th a r u c aa
ณัฐวรา	n a t^ th a w a r aa
ณัฐวัฒน์	n a t^ th a w a t^
ณัฐวิญญ์	n a t^ th a w i n^ j a j^
ณัฐวีร์	n a t^ th a w ii
ณัฐวุฒิ	n a t^ th a w u t^
ณัฐสิทธิ์	n a t^ th a s i t^
ณัฐสิมา	n a t^ s i m aa
ณัฐิยา	n a t^ th i j aa
ณัฐเดช	n a t^ th a d ee t^
ณัทฐ์ฐิตา	n a t^ th i t aa
ณัทธร	n a t^ th @@ n^
ณิชกานต์	n i t^ ch a k aa n^
ณิชชาพัณณ์	n i t^ ch aa ph a n^
ณิชชาอร	n i t^ ch aa z @@ n^
ณิชนันทวรรณ	n i t^ ch a n a n^ th a w a n^
ณิชภูมิ	n i ch a ph uu m^
ณิชา	n i ch aa
ณิชานันท์	n i ch aa n a n^
ณิชาภัทร	n i ch aa ph a t^
ณิชารีย์	n i ch aa r ii
ณิชาวรินทร์	n i ch aa w a r i n^
ณินท์	n i n^
ณิรัฐกานต์	n i r a t^ th a k aa n^
ณเดชน์	n a d ee t^
ดนัย	d a n a j^
ดนุพร	d a n u ph @@ n^
ดนุพล	d a n u ph o n^
ดนุภา	d a n u ph aa
ดนู	d a n uu
ดรัลชรัส	dr a n^ ch a j^ r a t^
ดรุณี	d a r u n ii
ดวงตา	d uua ng^ t aa
ดวงนภา	d uua ng^ n a ph aa
ดวงประเสริฐ	d uua ng^ pr a s qq t^
ดวงพร	d uua ng^ ph @@ n^
ดวงอนงค์	d uua ng^ z a n o ng^
ดวงเดือน	d uua ng^ d vva n^
ดวงเพชร	d uua ng^ ph ee t^
ดวงใจ	d uua ng^ c a j^
ดอกดิน	d @@ k^ d i n^
ดอกอ้อ	d @@ k^ z @@
ดอน	d @@ n^
ดอม	d @@ m^
ดัสกร	d a t^ s a k @@ n^
ดาบชัย	d aa p^ ch a j^
ดามพ์	d aa m^
ดารณี	d aa r a n ii
ดารณีนุช	d aa r a n ii n u t^
ดารัณ	d aa r a n^
ดารัตน์	d aa r a t^
ดาริน	d aa r i n^
ดารุณี	d aa r u n ii
ดาว	d aa w^
ดาวทอง	d aa w^ th @@ ng^
ดาวยศ	d aa w^ j o t^
ดาวรุ่ง	d aa w^ r u ng^
ดาวิกา	d aa w i k aa
ดาวิชญ์	d aa w i t^
ดาวิเด	d aa w i d ee
ดาวุฒิ	d aa w u t^
ดาวใจ	d aa w^ c a j^
ดาวใหม่	d aa w^ m a j^
ดาว์พงษ์	d aa w^ ph o ng^
ดำ	d a m^
ดำรง	d a m^ r o ng^
ดำรงค์	d a m^ r o ng^
ดำรงค์เดช	d a m^ r o ng^ d ee t^
ดำริ	d a m^ r i
ดินหิน	d i n^ h i n^
ดิลก	d i l o k^
ดิษยา	d i t^ s a j aa
ดิสทัต	d i t^ th a t^
ดิอุชา	d i z u ch aa
ดิเรก	d i r ee k^
ดีพร้อม	d ii phr @@ m^
ดีลิเลียน	d ii l i l iia n^
ดีเซลน้อย	d ii s ee n^ n @@ j^
ดีเด่น	d ii d e n^
ดีใจ	d ii c a j^
ดี๋	d ii
ดุจฝัน	d u t^ f a n^
ดุษฎี	d u t^ s a d ii
ดุสิต	d u s i t^
ดุสิตา	d u s i t aa
ดู๋	d uu
ตนุภัทร	t a n u ph a t^
ตระการ	tr a k aa n^
ตรัย	tr a j^
ตราวุธ	tr aa w u t^
ตรี	tr ii
ตรีชฎา	tr ii ch a d aa
ตรีดาว	tr ii d aa w^
ตรีทศ	tr ii th o t^
ตรีพล	tr ii ph o n^
ตรีรัก	tr ii r a k^
ตรีรัตน์	tr ii r a t^
ตวง	t uua ng^
ตวงพร	t uua ng^ ph @@ n^
ตวงรัตน์	t uua ng^ r a t^
ตวงสิทธิ์	t uua ng^ s i t^
ตะวัน	t a w a n^
ตัน	t a n^
ตั้ว	t uua
ตั๊กแตน	t a k^ t xx n^
ติณณภพ	t i n^ n a ph o p^
ติณณ์	t i n^
ติณภพ	t i n^ n a ph o p^
ติ๊ก	t i k^
ตี๋	t ii
ตุลย์	t u n^
ตุ่น	t u n^
ตุ้ม	t u m^
ตุ๊กกี้	t u k^ k ii
ต่วน	t uua n^
ต่อ	t @@
ต่อพงษ์	t @@ ph o ng^
ต่อศักดิ์	t @@ s a k^
ต่าย	t aa j^
ต้องตา	t @ ng^ t aa
ถกลเกียรติ	th a k o n^ k iia t^
ถนอม	th a n @@ m^
ถนอมจิต	th a n @@ m^ c i t^
ถนอมศักดิ์	th a n @@ m^ s a k^
ถนัด	th a n a t^
ถวัลย์	th a w a n^
ถวิล	th a w i n^
ถัด	th a t^
ถาวร	th aa w @@ n^
ถิร	th i r a
ถิรชัย	th i r a ch a j^
ถิรวัฒน์	th i r a w a t^
ถีรวิทย์	th ii r a w i t^
ถ้วน	th uua n^
ถ้ำเพชร	th a m^ ph ee t^
ทนง	th a n o ng^
ทนงศักดิ์	th a n o ng^ s a k^
ทนุศักดิ์	th a n u s a k^
ทมิฬ	th a m i n^
ทรง	s o ng^
ทรงกลด	s o ng^ kl o t^
ทรงกิตติ	s o ng^ k i t^ t i
ทรงชัย	s o ng^ ch a j^
ทรงพล	s o ng^ ph o n^
ทรงยศ	s o ng^ j o t^
ทรงศักดิ์	s o ng^ s a k^
ทรงสิทธิ์	s o ng^ s i t^
ทรัพย์สิรี	s a p^ s i r ii
ทราย	s aa j^
ทรายทอง	s aa j^ th @@ ng^
ทริสตอง	thr i t^ t @@ ng^
ทฤษฎี	thr i t^ s a d ii
ทวิช	th a w i t^
ทวี	th a w ii
ทวีชัย	th a w ii ch a j^
ทวีป	th a w ii p^
ทวีวัฒน์	th a w ii w a t^
ทวีศักดิ์	th a w ii s a k^
ทศพร	th o t^ s a ph @@ n^
ทศพล	th o t^ s a ph o n^
ทศวรรษ	th o t^ s a w a t^
ทศวี	th o t^ s a w ii
ทหาร	th a h aa n^
ทอง	th @@ ng^
ทองกราน	th @@ ng^ kr aa n^
ทองคำ	th @@ ng^ kh a m^
ทองดี	th @@ ng^ d ii
ทองภูมิ	th @@ ng^ ph uu m^
ทองสุข	th @@ ng^ s u k^
ทองหยด	th @@ ng^ j o t^
ทองหล่อ	th @@ ng^ l @@
ทองอินทร์	th @@ ng^ z i n^
ทองเทพ	th @@ ng^ th ee p^
ทองเบิ้ม	th @@ ng^ b qq m^
ทองเปลว	th @@ ng^ pl ee w^
ทองใบ	th @@ ng^ b a j^
ทองไท	th @@ ng^ th a j^
ทองไทเล็ก	th @@ ng^ th a j^ l e k^
ทอม	th @@ m^
ทักษอร	th a k^ s @@ z @@ n^
ทักษิณ	th a k^ s i n^
ทักษิณา	th a k^ s i n aa
ทัช	th a t^
ทัชชกร	th a t^ ch a k @@ n^
ทัดดาว	th a t^ d aa w^
ทัตพงษ์	th a t^ t a ph o ng^
ทันใจ	th a n^ c a j^
ทับ	th a p^
ทับทิมแดง	th a p^ th i m^ d xx ng^
ทัพทอง	th a p^ th @@ ng^
ทัศนัย	th a t^ s a n a j^
ทัศนาวลัย	th a t^ s a n aa w a l a j^
ทัศนียา	th a t^ s a n ii j aa
ทัศนีย์	th a t^ s a n ii
ทัศน์วรรณ	th a t^ w a n^
ทัศพร	th a t^ s a ph @@ n^
ทัศไนย	th a t^ s a n a j^
ทัฬห์	th a n^
ทาทา	th aa th aa
ทายาท	th aa j aa t^
ทาริกา	th aa r i k aa
ทิชา	th i ch aa
ทินกร	th i n^ k @@ n^
ทินพันธุ์	th i n^ n a ph a n^
ทินวัฒน์	th i n^ n a w a t^
ทิพนารี	th i ph a n aa r ii
ทิพย์	th i p^
ทิพย์อาภา	th i p^ z aa ph aa
ทิพาวดี	th i ph aa w a d ii
ทิววัฒน์	th i w^ w a t^
ทิวา	th i w aa
ทีป์ชลิต	th ii ch a l i t^
ทูน	th uu n^
ทูล	th uu n^
ทูลกระหม่อมหญิงอุบลรัตนราชกัญญา	th uu n^ kr a m @ m^ j i ng^ z u b o n^ r a t^ r aa t^ ch a k a n^ j aa
ท้วม	th uua m^
ท้าววรจันทร์	th aa w^ w @@ n^ c a n^
ธง	th o ng^
ธงชัย	th o ng^ ch a j^
ธงทศ	th o ng^ th o t^
ธงธง	th o ng^ th o ng^
ธงไชย	th o ng^ ch a j^
ธชตวัน	th a ch a t^ t a w a n^
ธชย	th a ch a j^
ธนกฤต	th a n a kr i t^
ธนฉัตร	th a n a ch a t^
ธนชัย	th a n a ch a j^
ธนญชัย	th o n^ j a ch a j^
ธนดล	th a n a d o n^
ธนทัต	th a n a th a t^
ธนนท์	th a n o n^
ธนบดี	th a n a b @@ d ii
ธนบูรณ์	th a n a b uu n^
ธนพร	th a n a ph @@ n^
ธนพล	th a n a ph o n^
ธนภพ	th a n a ph o p^
ธนวรรณ	th a n a w a n^
ธนวัฒน์	th a n a w a t^
ธนวิช	th a n a w i t^
ธนษิต	th a n a s i t^
ธนะรัศมิ์ฐา	th a n a r a t^ th aa
ธนะศักดิ์	th a n a s a k^
ธนะสิทธิ์	th a n a s i t^
ธนัชชัย	th a n a t^ ch a j^
ธนัชชา	th a n a t^ ch aa
ธนัญชัย	th a n a n^ ch a j^
ธนัตถ์	th a n a t^
ธนัตถ์ศรันย์	th a n a t^ s a r a n^
ธนัท	th a n a t^
ธนันต์ธรญ์	th a n a n^ th a
ธนัยนันท์	th a n a j^ n a n^
ธนัสถา	th a n a t^ th aa
ธนา	th a n aa
ธนากร	th a n aa k @@ n^
ธนาตย์	th a n aa t^
ธนาธร	th a n aa th @@ n^
ธนาภรณ์	th a n aa ph @@ n^
ธนาภา	th a n aa ph aa
ธนายง	th a n aa j o ng^
ธนาวุฒิ	th a n aa w u t^
ธนาสิทธิ์	th a n aa s i t^
ธนิก	th a n i k^
ธนิดา	th a n i d aa
ธนิต	th a n i t^
ธนิตพล	th a n i t^ ph o n^
ธนิตย์	th a n i t^
ธนิน	th a n i n^
ธนินท์	th a n i n^
ธนินวัฒน์	th a n i n^ n a w a t^
ธนิยา	th a n i j aa
ธนิสร์	th a n i t^
ธนีกาญจน์	th a n ii k aa n^
ธนู	th a n uu
ธนูศึก	th a n uu s v k^
ธนเกียรติ	th a n a k iia t^
ธนเวทย์	th a n a w ee t^
ธนโชติ	th a n a ch oo t^
ธมจันทร์	th o m^ c a n^
ธมลวรรณ	th a m o n^ w a n^
ธรณิศ	th @@ r a n i t^
ธรรมชาติ	th a m^ m a ch aa t^
ธรรมทาส	th a m^ m a th aa t^
ธรรมนูญ	th a m^ m a n uu n^
ธรรมยุทธ	th a m^ m a j u t^
ธรรมรงค์	th a m^ m a r o ng^
ธรรมรส	th a m^ m a r o t^
ธรรมรักษ์	th a m^ m a r a k^
ธรรมวิชญ์	th a m^ m a w i t^
ธรัช	th a r a t^
ธรากร	th a r aa k @@ n^
ธราธร	th a r aa th @@ n^
ธราภา	th a r aa ph aa
ธราวุธ	th a r aa w u t^
ธฤติ	th a r v t^
ธวัช	th a w a t^
ธวัชชัย	th a w a t^ ch a j^
ธวัชวงศ์	th a w a t^ ch a w o ng^
ธัชชา	th a t^ ch aa
ธัชพล	th a t^ ch a ph o n^
ธัญ	th a n^
ธัญชนก	th a n^ j a ch a n o k^
ธัญญชล	th a n^ j a ch o n^
ธัญญรัศม์	th a n^ j a r a t^
ธัญญวีร์	th a n^ j a w ii
ธัญญะสุภางค์	th a n^ j a s u ph aa ng^
ธัญญา	th a n^ j aa
ธัญญาเรศ	th a n^ j aa r ee t^
ธัญญ่า	th a n^ j aa
ธัญญ์	th a n^ j a j^
ธัญญ์วาริน	th a n^ j a w aa r i n^
ธัญนันท์	th a n^ j a n a n^
ธัญนิตย์	th a n^ j a n i t^
ธัญยกันต์	th a n^ j a j oo k a n^
ธัญยธรณ์	th a n^ j a j^ th @@ n^
ธัญลักษณ์	th a n^ j a l a k^
ธัญวิสิฎฐ์	th a n^ j a w i s i t^
ธัญสก	th a n^ j a s o k^
ธัญสินี	th a n^ s i n ii
ธัญสุดา	th a n^ j a s u d aa
ธันยนันท์	th a n^ j a n a n^
ธันยพร	th a n^ j a ph @@ n^
ธันย์ชนก	th a n^ ch a n o k^
ธันวา	th a n^ w aa
ธาดา	th aa d aa
ธาตรี	th aa tr ii
ธานัท	th aa n a t^
ธานินทร์	th aa n i n^
ธานี	th aa n ii
ธามไท	th aa m^ th a j^
ธารทอง	th aa n^ th @@ ng^
ธารทิพย์	th aa n^ th i p^
ธารา	th aa r aa
ธาราทิพย์	th aa r aa th i p^
ธาราเขต	th aa r aa kh ee t^
ธาริต	th aa r i t^
ธารินทร์	th aa r i n^
ธาริษา	th aa r i s aa
ธารไชยยันต์	th aa n^ ch a j^ j a n^
ธาวิน	th aa w i n^
ธำรง	th a m^ r o ng^
ธำรงค์	th a m^ r o ng^
ธำรงศักดิ์	th a m^ r o ng^ s a k^
ธิญาดา	th i j aa d aa
ธิฎาภา	th i d aa ph aa
ธิดา	th i d aa
ธิติ	th i t i
ธิตินันท์	th i t i n a n^
ธิติมา	th i t i m aa
ธิติยา	th i t i j aa
ธีมะ	th ii m a
ธีรชัย	th ii r a ch a j^
ธีรชา	th ii r a ch aa
ธีรดนย์	th ii r a d a n ee
ธีรดา	th ii r a d aa
ธีรนันท์	th ii r a n a n^
ธีรนัยน์	th ii r a n a j^
ธีรพงศ์	th ii r a ph o ng^
ธีรพงษ์	th ii r a ph o ng^
ธีรพล	th ii r a ph o n^
ธีรภัทร	th ii r a ph a t^
ธีรภัทร์	th ii r a ph a t^
ธีรยุทธ	th ii r a j u t^
ธีรรัตน์	th ii r a r a t^
ธีรวัฒน์	th ii r a w a t^
ธีรวุฒิ	th ii r a w u t^
ธีรศักดิ์	th ii r a s a k^
ธีรศิลป์	th ii r a s i n^
ธีระ	th ii r a
ธีระชัย	th ii r a ch a j^
ธีระพร	th ii r a ph @@ n^
ธีระพล	th ii r a ph o n^
ธีระพันธ์	th ii r a ph a n^
ธีระวัฒน์	th ii r a w a t^
ธีระศักดิ์	th ii r a s a k^
ธีระเกียรติ	th ii r a k iia t^
ธีรัตถ์	th ii r a t^
ธีราทร	th ii r aa th @@ n^
ธีรเกียรติ์	th ii r a k iia t^
ธีรเดช	th ii r a d ee t^
ธีรเทพ	th ii r a th ee p^
ธีร์	th ii
ธีร์ศิลป์	th ii s i n^
ธุรกิจ	th u r a k i t^
ธุรดี	th u r a d ii
ธเนศ	th a n ee t^
ธเนศวร์	th a n ee t^
นกน้อย	n o k^ n @@ j^
นกหวีด	n o k^ w ii t^
นครินทร์	n a kh a r i n^
นคุณ	n a kh u n^
นงเยาว์	n o ng^ j a w^
นท	n o t^
นที	n a th ii
นน	n o n^
นนทนันท์	n o n^ th a n a n^
นนทพร	n o n^ th a ph @@ n^
นนทพัฒน์	n o n^ th a ph a t^
นนทพันธ์	n o n^ th a ph a n^
นนทรีย์	n o n^ s ii
นนทศิลป์	n o n^ th a s i n^
นนทิวรรธน์	n o n^ th i w a t^
นนท์	n o n^
นนธวรรณ	n o n^ th a w a n^
นพคุณ	n o p^ ph a kh u n^
นพชัย	n o p^ ph a ch a j^
นพดล	n o p^ ph a d o n^
นพนนท์	n o p^ ph a n o n^
นพปฎล	n a ph a p a d o n^
นพพร	n o p^ ph @@ n^
นพพล	n o p^ ph o n^
นพพันธ์	n o p^ ph a n^
นพรัตน์น้อย	n o p^ ph a r a t^ n @@ j^
นพฤทธิ์	n o p^ ph a r i t^
นพวรรณ	n o p^ ph a w a n^
นพัตฏ์ธร	n a ph a t^ t^ th @@ n^
นพเก้า	n o p^ ph a k aa w^
นภ	n o p^ ph a
นภคปภา	n o p^ ph a kh a p a ph aa
นภสร	n o p^ ph a s @@ n^
นภัทร	n a ph a t^
นภัทร์	n a ph a t^
นภัส	n a ph a t^
นภัสธนันท์	n a ph a t^ th a n a n^
นภัสสร	n a ph a t^ s @@ n^
นภา	n a ph aa
นภาพร	n a ph aa ph @@ n^
นภาพล	n a ph aa ph o n^
นภาลัย	n a ph aa l a j^
นรนิติ	n @@ r a n i t^
นรพล	n @@ r a ph o n^
นรภัทร	n @@ r a ph a t^
นรสิงห์	n @@ r a s i ng^
นรากร	n a r aa k @@ n^
นราธร	n a r aa th @@ n^
นราพร	n a r aa ph @@ n^
นราพัฒน์	n a r aa ph a t^
นรารักษ์	n a r aa r a k^
นริศ	n a r i t^
นริศร	n a r i t^ s @@ n^
นริศรา	n a r i t^ s a r aa
นริส	n a r i t^
นรีกุล	n a r ii k u n^
นรเทพ	n @@ r a th ee p^
นฤชาติ	n a r v ch aa t^
นฤพนธ์	n a r v ph o n^
นฤพล	n a r v ph o n^
นฤภรกมล	n a r v ph @@ n^ k a m o n^
นฤมล	n a r v m o n^
นฤเบศ	n a r v b ee t^
นฤเบศร์	n a r v b ee t^
นล	n o n^
นลิน	n a l i n^
นลินทิพย์	n a l i n^ th i p^
นลินี	n a l i n ii
นวดี	n a w a d ii
นวปฎล	n a w a p a d o n^
นวพล	n a w a ph o n^
นวมทอง	n uua m^ th @@ ng^
นวมินทร์	n a w a m i n^
นวรัตน์	n a w a r a t^
นวัธ	n a w a t^
นวินดา	n a w i n^ d aa
นัชชา	n a t^ ch aa
นัฏฐา	n a t^ th aa
นัฐฐพนธ์	n a t^ th a ph o n^
นัฐพล	n a t^ th a ph o n^
นัดตะวัน	n a t^ t a w a n^
นัตยา	n a t^ t a j aa
นัท	n a t^
นัทธพงศ์	n a t^ th a ph o ng^
นัทธินันท์	n a t^ th i n a n^
นันญ์จีรา	n a n^ c ii r aa
นันทกานต์	n a n^ th a k aa n^
นันทนัช	n a n^ th a n a t^
นันทนา	n a n^ th a n aa
นันทพร	n a n^ th a ph @@ n^
นันทพล	n a n^ th a ph o n^
นันทริกา	n a n^ th a r i k aa
นันทวัฒน์	n a n^ th a w a t^
นันทวุฒิ	n a n^ th a w u t^
นันทศัย	n a n^ th a s a j^
นันทิกานต์	n a n^ th i k aa n^
นันทิดา	n a n^ th i d aa
นันทิตา	n a n^ th i t aa
นันทิยา	n a n^ th i j aa
นันทโชติ	n a n^ th a ch oo t^
นันท์สินี	n a n^ s i n ii
นันนภัส	n a n^ n a ph a t^
นัยนา	n a j^ j a n aa
นัสตพล	n a t^ t a ph o n^
นาคร	n aa kh @@ n^
นาชา	n aa ch aa
นาตยา	n aa t^ t a j aa
นาตาชา	n aa t aa ch aa
นาตาลี	n aa t aa l ii
นาถยา	n aa t^ th a j aa
นาท	n aa t^
นาที	n aa th ii
นาธาน	n aa th aa n^
นาม	n aa m^
นายิกา	n aa j i k aa
นารถ	n aa t^
นาระ	n aa r a
นารา	n aa r aa
นารากร	n aa r aa k @@ n^
นาราชา	n aa r aa ch aa
นารี	n aa r ii
นารุโตะ	n aa r u t o
นาวิน	n aa w i n^
นาเดีย	n aa d iia
นำขบวน	n a m^ kh a b uua n^
นำชัย	n a m^ ch a j^
นำพล	n a m^ ph o n^
นำยุทธ	n a m^ j u t^
นำศักดิ์น้อย	n a m^ s a k^ n @@ j^
นิกร	n i k @@ n^
นิกัลยา	n i k a n^ l a j aa
นิคม	n i kh o m^
นิจชิตา	n i t^ ch i t aa
นิชคุณ	n i t^ ch a kh u n^
นิตยา	n i t^ t a j aa
นิตย์	n i t^
นิติ	n i t i
นิติพงษ์	n i t i ph o ng^
นิติภูมิ	n i t i ph uu m^
นิติรัฐ	n i t i r a t^
นิติวัฒน์	n i t i w a t^
นิทัศน์	n i th a t^
นิธิ	n i th i
นิธิกร	n i th i k @@ n^
นิธิชัย	n i th i ch a j^
นิธิดล	n i th i d o n^
นิธินันท์	n i th i n a n^
นิธินาฎ	n i th i n aa t^
นิธิพัฒน์	n i th i ph a t^
นิธิวรรธก์	n i th i w a t^
นิธิวัฒน์	n i th i w a t^
นิธิศ	n i th i t^
นิพนธ์	n i ph o n^
นิพิฏฐ์	n i ph i t^
นิพิฐพนธ์	n i ph i t^ ph o n^
นิพิธ	n i ph i t^
นิภาภรณ์	n i ph aa ph @@ n^
นิมิต	n i m i t^
นิมิตร	n i m i t^
นิยม	n i j o m^
นิรมล	n i r a m o n^
นิรมิต	n i r a m i t^
นิรวัชช์	n i r a w a t^
นิรัตติศัย	n i r a t^ t i s a j^
นิรันดร์	n i r a n^
นิรุจน์	n i r u t^
นิรุตติ์	n i r u t^
นิล	n i n^
นิลวรรณ	n i n^ w a n^
นิวัฒน์	n i w a t^
นิวัฒน์ธำรง	n i w a t^ th a m^ r o ng^
นิวัติ	n i w a t^
นิศาชล	n i s aa ch o n^
นิษฐา	n i t^ th aa
นิษิตา	n i s i t aa
นิสสัย	n i t^ s a j^
นิสา	n i s aa
นิออน	n i z @@ n^
นิฮาฟิล	n i h aa f i l^
นิเวศน์	n i w ee t^
นิเวส	n i w ee t^
นิโคล	n i kh oo n^
นิ่ม	n i m^
นีร	n ii r a
นุกูล	n u k uu n^
นุชรินทร์	n u t^ ch a r i n^
นุชรี	n u t^ ch a r ii
นุติ	n u t^
นุศรา	n u s a r aa
นุสบา	n u t^ s a b aa
นุสรา	n u t^ s a r aa
นุ้ย	n u j^
นูรูล	n uu r uu l^
น็อคเอาท์	n @ k^ z a w^
น้องหมวย	n @@ ng^ m uua j^
น้องเบิร์ด	n @@ ng^ b qq t^
น้องโรส	n @@ ng^ r o t^
น้องใหม่	n @@ ng^ m a j^
น้อย	n @@ j^
น้ำทิพย์	n aa m^ th i p^
น้ำผึ้ง	n aa m^ ph v ng^
น้ำฝน	n aa m^ f o n^
น้ำหนึ่ง	n aa m^ n v ng^
น้ำอ้อย	n aa m^ z @@ j^
น้ำเงิน	n aa m^ ng qq n^
บงกช	b o ng^ k o t^
บดินทร์	b @@ d i n^
บดี	b @@ d ii
บรม	b @@ r o m^
บรมวุฒิ	b @@ r o m^ m a w u t^
บรรจง	b a n^ c o ng^
บรรจบ	b a n^ c o p^
บรรยิน	b a n^ j i n^
บรรหาร	b a n^ h aa n^
บรรเจิด	b a n^ c qq t^
บรรเทา	b a n^ th a w^
บริบูรณ์	b @@ r i b uu n^
บวร	b a w @@ n^
บวรศักดิ์	b a w @@ n^ s a k^
บอย	b @@ j^
บังสะเล็บ	b a ng^ s a l e p^
บัญชา	b a n^ ch aa
บัญญัติ	b a n^ j a t^
บัณจงศักดิ์	b a n^ c o ng^ s a k^
บัณฑิกา	b a n^ th i k aa
บัณฑิต	b a n^ d i t^
บัณฑิตา	b a n^ th i t aa
บัณฑูร	b a n^ th uu n^
บัว	b uua
บัวขาว	b uua kh aa w^
บัวชมพู	b uua ch o m^ ph uu
บัวซอน	b uua s @@ n^
บัวบาน	b uua b aa n^
บัวผัน	b uua ph a n^
บัวลา	b uua l aa
บัวหลวง	b uua l uua ng^
บัวเขียว	b uua kh iia w^
บางแสน	b aa ng^ s xx n^
บานเย็น	b aa n^ j e n^
บิณฑ์	b i n^
บินหลา	b i n^ l aa
บิล	b i l^
บิลลี่	b i n^ l ii
บิว	b i w^
บิ๊กเบน	b i k^ b ee n^
บี้	b ii
บุญคลี	b u n^ khl ii
บุญจง	b u n^ c o ng^
บุญชง	b u n^ ch o ng^
บุญชนะ	b u n^ ch a n a
บุญชัย	b u n^ ch a j^
บุญชู	b u n^ ch uu
บุญช่วย	b u n^ ch uua j^
บุญฐิน	b u n^ j a th i n^
บุญถึง	b u n^ th v ng^
บุญทรง	b u n^ s o ng^
บุญทิน	b u n^ th i n^
บุญผ่อง	b u n^ ph @@ ng^
บุญพันธ์	b u n^ ph a n^
บุญพิทักษ์	b u n^ ph i th a k^
บุญมาก	b u n^ m aa k^
บุญมี	b u n^ m ii
บุญยง	b u n^ j o ng^
บุญยงค์	b u n^ j o ng^
บุญยอด	b u n^ j @@ t^
บุญยิสา	b u n^ j i s aa
บุญรอด	b u n^ r @@ t^
บุญรัตน์	b u n^ r a t^
บุญรื่น	b u n^ r vv n^
บุญศรี	b u n^ s ii
บุญศักดิ์	b u n^ s a k^
บุญสนอง	b u n^ s a n @@ ng^
บุญสม	b u n^ s o m^
บุญสร้าง	b u n^ s aa ng^
บุญสืบ	b u n^ s vv p^
บุญส่ง	b u n^ s o ng^
บุญหลง	b u n^ l o ng^
บุญเกิด	b u n^ k qq t^
บุญเกียรติ	b u n^ k iia t^
บุญเกื้อ	b u n^ k vva
บุญเติม	b u n^ j a t qq m^
บุญเท่ง	b u n^ th ee ng^
บุญเลิศ	b u n^ l qq t^
บุญเอื้อ	b u n^ z vva
บุญแก้ว	b u n^ k xx w^
บุณคณาวัฒน์	b u n^ kh a n aa w a t^
บุณยวีร์	b u n^ j a w ii
บุณย์ธิดา	b u n^ th i d aa
บุตรศรัณย์	b u t^ s a r a n^
บุตรี	b u t^ tr ii
บุบผา	b u p^ ph aa
บุปผา	b u p^ ph aa
บุรณัชย์	b u r a n a t^
บุรินทร์	b u r i n^
บุศนันทน์	b u t^ s a n a n^
บุศย์สิริ	b u t^ s i r i
บุศรา	b u t^ s a r aa
บุศริณธญ์	b u t^ s a r i n^ th
บุษกร	b u t^ s a k @@ n^
บุษบา	b u t^ s a b aa
บุษบากร	b u t^ s a b aa k @@ n^
บุษยา	b u t^ s a j aa
บูรณิจฉ์	b uu r a n i t^ ch
ปกฉัตร	p o k^ k a ch a t^
ปกรณ์	p a k @@ n^
ปกิต	p a k i t^
ปกเกล้า	p o k^ kl a w^
ปชาบดี	p a ch aa b @@ d ii
ปฏิพัทธ์	p a t i ph a t^
ปฏิภาณ	p a t i ph aa n^
ปฏิวัติ	p a t i w a t^
ปฏิเวธ	p a t i w ee t^
ปฐมชัย	p a th o m^ ch a j^
ปฐมพงศ์	p a th o m^ ph o ng^
ปฐมพงษ์	p a th o m^ ph o ng^
ปฐมพร	p a th o m^ ph @@ n^
ปฐมศึก	p a th o m^ m a s v k^
ปฐมสิทธิ์	p a th o m^ m a s i t^
ปฐมโชค	p a th o m^ ch oo k^
ปณวัตร	p a n a w a t^
ปณิศา	p a n i s aa
ปทิตตา	p a th i t^ t aa
ปทีป	p a th ii p^
ปทุมวดี	p a th u m^ w a d ii
ปนัดดา	p a n a t^ d aa
ปนัสยา	p a n a t^ s a j aa
ปภัสรา	p a ph a t^ aa
ปภัสสร	p a ph a t^ s @@ n^
ปภาดา	p a ph aa d aa
ปภาวิน	p a ph aa w i n^
ปยุต	p a j u t^
ประกอบ	pr a k @@ p^
ประกาศ	pr a k aa t^
ประกาศิต	pr a k aa s i t^
ประกิต	pr a k i t^
ประคิณ	pr a kh i n^
ประจวบ	pr a c uua p^
ประจักษ์	pr a c a k^
ประจิน	pr a c i n^
ประชัย	pr a ch a j^
ประชา	pr a ch aa
ประชุม	pr a ch u m^
ประณีต	pr a n ii t^
ประดิษฐ	pr a d i t^
ประดิษฐ์	pr a d i t^
ประทวน	pr a th uua n^
ประทิน	pr a th i n^
ประทีป	pr a th ii p^
ประทุม	pr a th u m^
ประธาน	pr a th aa n^
ประนอม	pr a n @@ m^
ประพร	pr a ph @@ n^
ประพัฒน์	pr a ph a t^
ประพันธ์	pr a ph a n^
ประพันธ์ศักดิ์	pr a ph a n^ s a k^
ประพาส	pr a ph aa t^
ประพิมพ์พร	pr a ph i m^ ph @@ n^
ประภัตร	pr a ph a t^
ประภัทรพงศ์	pr a ph a t^ th a r a ph o ng^
ประภัทร์	pr a ph a t^
ประภัสสร	pr a ph a t^ s @@ n^
ประภาพ	pr a ph aa p^
ประภาวดี	pr a ph aa w a d ii
ประภาศน์	pr a ph aa t^
ประภาส	pr a ph aa t^
ประมณฑ์	pr a m o n^
ประมวนศักดิ์	pr a m uua n^ s a k^
ประมวล	pr a m uua n^
ประมาณ	pr a m aa n^
ประมุขพิสิฐ	pr a m u k^ ph i s i t^
ประมูล	pr a m uu n^
ประยงค์	pr a j o ng^
ประยอม	pr a j @@ m^
ประยุทธ	pr a j u t^
ประยุทธ์	pr a j u t^
ประยูร	pr a j uu n^
ประยูรศักดิ์	pr a j uu n^ s a k^
ประลอง	pr a l @@ ng^
ประวัฒน์	pr a w a t^
ประวัติ	pr a w a t^
ประวิช	pr a w i t^
ประวิตร	pr a w i t^
ประวิทย์	pr a w i t^
ประวีณวัช	pr a w ii n^ w a t^
ประสงค์	pr a s o ng^
ประสพ	pr a s o p^
ประสพสุข	pr a s o p^ s u k^
ประสม	pr a s o m^
ประสาท	pr a s aa t^
ประสิทธิ์	pr a s i t^
ประหยัด	pr a j a t^
ประเดิม	pr a d qq m^
ประเทศ	pr a th ee t^
ประเทียบ	pr a th iia p^
ประเทือง	pr a th vva ng^
ประเวศ	pr a w ee t^
ประเวศน์	pr a w ee t^
ประเสริฐ	pr a s qq t^
ประแสง	pr a s xx ng^
ประโยชน์	pr a j oo t^
ประไพพรรณ	pr a ph a j^ ph a n^
ปรัชญา	pr a t^ j aa
ปรัชญ์	pr a t^
ปรัชญ์ธนวิชญ์	pr a t^ th a n a w i t^
ปราการ	pr aa k aa n^
ปราจิน	pr aa c i n^
ปราจีน	pr aa c ii n^
ปราชญา	pr aa t^ ch a j aa
ปราบ	pr aa p^
ปราบดา	pr aa p^ d aa
ปราบธรณี	pr aa p^ th @@ r a n ii
ปราบไพรี	pr aa p^ ph a j^ r ii
ปราปต์ปฎล	pr aa p^ p a d o n^
ปราย	pr aa j^
ปรารถนา	pr aa t^ th a n aa
ปราโมทย์	pr aa m oo t^
ปริญ	p a r i n^
ปริญญวัฒน์	p a r i n^ j a w a t^
ปริญญา	p a r i n^ j aa
ปริญญ์	p a r i n^ j
ปริตา	pr i t aa
ปริภัณฑ์	p a r i ph a n^
ปริยานุช	pr i j aa n u t^
ปริศนา	pr i t^ s a n aa
ปริษา	p a r i s aa
ปรีชญา	pr ii ch a j aa
ปรีชา	pr ii ch aa
ปรีชาพล	pr ii ch aa ph o n^
ปรีดา	pr ii d aa
ปรีดี	pr ii d ii
ปรียวิศว์	pr ii j a w i t^
ปรียา	pr ii j aa
ปรียากานต์	pr ii j aa k aa n^
ปรเมศย์	p @@ r a m ee t^
ปรเมศวร์	p @@ r a m ee t^
ปลอดประสพ	pl @@ t^ pr a s o p^
ปลาคราฟ	pl aa khr aa p^
ปลื้มจิตร์	pl vv m^ c i t^
ปวรรัตน์	p @@ w @@ r a r a t^
ปวริศา	p a w a r i s aa
ปวันรัตน์	p a w a n^ r a t^
ปวิณ	p a w i n^
ปวิตร	p a w i t^
ปวิน	p a w i n^
ปวีณ	p a w ii n^
ปวีณา	p a w ii n aa
ปวีณ์สุดา	p a w ii n^ s u d aa
ปวีร์	p a w ii
ปอง	p @@ ng^
ปองพล	p @@ ng^ ph o n^
ปองภพ	p @@ ng^ ph o p^
ปองวุฒิ	p @@ ng^ w u t^
ปองศักดิ์	p @@ ng^ s a k^
ปอยฝ้าย	p @@ j^ f aa j^
ปอรรัชม์	p @@ r a r a t^
ปักษิณ	p a k^ s i n^
ปัจจัย	p a t^ c a j^
ปัญจะ	p a n^ c a
ปัญญวัฒน์	p a n^ j a w a t^
ปัญญา	p a n^ j aa
ปัญสิกรณ์	p a n^ j a s i k @@ n^
ปัฏฐา	p a t^ th aa
ปัณณวิชญ์	p a n^ n a w i t^
ปัทมวรรณ	p a t^ th a m a w a n^
ปัทมา	p a t^ th a m aa
ปาณรวัฐ	p aa n @@ w a t^
ปาณิชดา	p aa n i t^ ch a d aa
ปาณิศา	p aa n i s aa
ปาณิสรา	p aa n i t^ s a r aa
ปาน	p aa n^
ปานปรีย์	p aa n^ pr ii
ปานพิมพ์	p aa n^ ph i m^
ปานรดา	p aa n^ r a d aa
ปานระพี	p aa n^ r a ph ii
ปานวาด	p aa n^ w aa t^
ปานวาศ	p aa n^ w aa t^
ปานหทัย	p aa n^ h a th a j^
ปานเทพ	p aa n^ th ee p^
ปาริชาติ	p aa r i ch aa t^
ปารีณา	p aa r ii n aa
ปารเมศ	p aa r a m ee t^
ปาหุณ	p aa h u n^
ปิติ	p i t i
ปิติพงษ์	p i t i ph o ng^
ปิติศักดิ์	p i t i s a k^
ปิยณี	p i j a n ii
ปิยดา	p i j a d aa
ปิยธิดา	p i j a th i d aa
ปิยนุช	p i j a n u t^
ปิยพงษ์	p i j a ph o ng^
ปิยพล	p i j a ph o n^
ปิยพันธุ์	p i j a ph a n^
ปิยพันธ์	p i j a ph a n^
ปิยวดี	p i j a w a d ii
ปิยวัฒน	p i j a w a t^ th a n a
ปิยสวัสดิ์	p i j a s a w a t^
ปิยะ	p i j a
ปิยะกุล	p i j a k u n^
ปิยะชาติ	p i j a ch aa t^
ปิยะณัฐ	p i j a n a t^
ปิยะดา	p i j a d aa
ปิยะทิพย์	p i j a th i p^
ปิยะธาดา	p i j a th aa d aa
ปิยะนุช	p i j a n u t^
ปิยะบุตร	p i j a b u t^
ปิยะพงษ์	p i j a ph o ng^
ปิยะพันธ์	p i j a ph a n^
ปิยะพันธ์ุ	p i j a ph a n^ u
ปิยะมาศ	p i j a m aa t^
ปิยะรัฐ	p i j a r a t^
ปิยะวัฒน์	p i j a w a t^
ปิยะวิทย์	p i j a w i t^
ปิ่นสุดา	p i n^ s u d aa
ปิ๊กมี่	p i k^ m ii
ปีศาจแดง	p ii s aa t^ d xx ng^
ปีเตอร์	p ii t qq
ปืนกล	p vv n^ k o n^
ปุณณภพ	p u n^ n a ph o p^
ปุณณรัตน์	p u n^ n a r a t^
ปุณณิสา	p u n^ n i s aa
ปุณยวีร์	p u n^ j a w ii
ปุณยาพร	p u n^ j aa ph @@ n^
ปุณิกา	p u n i k aa
ปุระชัย	p u r a ch a j^
ปุริม	p u r i m^
ป่านทอทอง	p aa n^ th @@ th @@ ng^
ป้องเพชร	p @@ ng^ ph ee t^
ป้อมเพชร	p @@ m^ ph ee t^
ป๋วย	p uua j^
ผจญ	ph a c o n^
ผณินทรา	ph a n i n^ tr aa
ผดุง	ph a d u ng^
ผล	ph o n^
ผลิตโชค	ph a l i t^ ch oo k^
ผัน	ph a n^
ผาสุก	ph aa s u k^
ผิน	ph i n^
ผึ้งหลวง	ph v ng^ l uua ng^
ผุดผาดน้อย	ph u t^ ph aa t^ n @@ j^
ผุสชา	ph u s^ ch aa
ผุสดี	ph u t^ s a d ii
ผไทมาส	ph th a m aa t^
ผ่องศรี	ph @ ng^ s ii
ฝน	f o n^
ฝนทิพย์	f o n^ th i p^
พงค์พิพัฒน์	ph o ng^ ph i ph a t^
พงศกร	ph o ng^ s a k @@ n^
พงศธร	ph o ng^ s a th @@ n^
พงศพัศ	ph o ng^ s a ph a t^
พงศ์ชนก	ph o ng^ ch a n o k^
พงศ์ประยูร	ph o ng^ pr a j uu n^
พงศ์พรหม	ph o ng^ phr o m^
พงศ์พัฒน์	ph o ng^ ph a t^
พงศ์พันธ์	ph o ng^ ph a n^
พงศ์พีระ	ph o ng^ ph ii r a
พงศ์ศักดิ์	ph o ng^ s a k^
พงศ์สิรี	ph o ng^ s i r ii
พงศ์สุข	ph o ng^ s u k^
พงศ์เทพ	ph o ng^ th ee p^
พงศ์เวช	ph o ng^ w ee t^
พงศ์โพยม	ph o ng^ ph a j oo m^
พงษ์ชนะ	ph o ng^ ch a n a
พงษ์นิวัฒน์	ph o ng^ n i w a t^
พงษ์พัฒน์	ph o ng^ ph a t^
พงษ์พันธุ์	ph o ng^ ph a n^
พงษ์พิสุทธิ์	ph o ng^ ph i s u t^
พงษ์ศักดิ์	ph o ng^ s a k^
พงษ์ศักดิ์เล็ก	ph o ng^ s a k^ l e k^
พงษ์ศิริ	ph o ng^ s i r i
พงษ์สิทธิ์	ph o ng^ s i t^
พงษ์อุดม	ph o ng^ z u d o m^
พงษ์เทพ	ph o ng^ th ee p^
พงษ์เพชร	ph o ng^ ph ee t^
พงส์	ph o ng^
พจนาถ	ph o t^ c a n aa t^
พจนารถ	ph o t^ c a n aa t^
พจน์	ph o t^
พจมาน	ph o t^ c a m aa n^
พชร	ph a ch a r a
พชรกมล	ph a ch a r a k a m o n^
พชรพรรณ	ph a ch a r a ph a n^
พนม	ph a n o m^
พนมกร	ph a n o m^ k @@ n^
พนมกรณ์	ph a n o m^ k @@ n^
พนมรุ้งเล็ก	ph a n o m^ r u ng^ l e k^
พนมเดช	ph a n o m^ d ee t^
พนมไพร	ph a n o m^ phr a j^
พนัส	ph a n a t^
พนา	ph a n aa
พนิช	ph a n i t^
พนิดา	ph a n i d aa
พนิตา	ph a n i t aa
พยงค์	ph a j o ng^
พยอม	ph a j @@ m^
พยัคฆ์	ph a j a k^
พร	ph @@ n^
พรชนก	phr a ch a n o k^
พรชัย	ph @@ n^ ch a j^
พรชิตา	ph @@ n^ ch i t aa
พรทิพย์	ph @@ n^ th i p^
พรทิวา	ph @@ n^ th i w aa
พรนับพัน	ph @@ n^ n a p^ ph a n^
พรปวีณ์	ph @@ n^ p a w ii n^ n a w o ng^
พรปวีร์	ph @@ n^ p a w ii
พรพรรณ	ph @@ n^ ph a n^
พรพิชญ์	ph @@ n^ ph i t^
พรพิพัฒน์	ph @@ n^ ph i ph a t^
พรพิมล	ph @@ n^ ph i m o n^
พรรณนภา	ph a n^ n a ph aa
พรรณนิภา	ph a n^ n i ph aa
พรรณปพร	ph a n^ n a p a ph @@ n^
พรรณวดี	ph a n^ n a w a d ii
พรรณวรท	ph a n^ w xx t^
พรรณสิริ	ph a n^ s i r i
พรรณี	ph a n^ n ii
พรรษชล	ph a n^ s a ch o n^
พรรษา	ph a n^ s aa
พรรัมภา	ph @@ n^ r a m^ ph aa
พรวรา	ph @@ n^ w a r aa
พรวุฒิ	ph @@ n^ w u t^
พรศักดิ์	ph @@ n^ s a k^
พรสรรค์	ph @@ n^ s a n^
พรสวรรค์	ph @@ n^ s a w a n^
พรสุดา	ph @@ n^ s u d aa
พรหมธร	phr o m^ m a th @@ n^
พรหมพร	phr o m^ ph @@ n^
พรหมมินทร์	phr o m^ m i n^
พรหมินทร์	phr o m^ m i n^
พระครูจ้อย	phr a khr uu c @ j^
พระจันทร์ฉาย	phr a c a n^ ch aa j^
พระนางเจ้าสุวัทนา	phr a n aa ng^ c aa w^ s u w a t^ th a n aa
พระนาย	phr a n aa j^
พระบาทสมเด็จพระบรมชนกาธิเบศร	phr a b aa t^ s o m^ d e t^ phr a b @@ r o m^ m a ch o n^ n a k aa th i b ee t^
พระบาทสมเด็จพระปรเมนทรมหาอานันทมหิดล	phr a b aa t^ s o m^ d e t^ phr a p @@ r a m ee n^ th a r a m a h aa z aa n a n^ th a m a h i d o n^
พระบาทสมเด็จพระปรเมนทรรามาธิบดีศรีสินทรมหาวชิราลงกรณ	phr a b aa t^ s o m^ d e t^ phr a p @@ r a m ee n^ r aa m aa th i p^ b @@ d ii s ii s i n^ th a r a m a h aa w a ch i r aa l o ng^ k @@ n^
พระพรหมมังคลาจารย์	phr a phr o m^ m a ng^ k a l aa c aa n^
พระมหาธรรมราชาที่	phr a m a h aa th a m^ m a r aa ch aa th ii
พระมหาวุฒิชัย	phr a m a h aa w u t^ th i ch a j^
พระมหาสมปอง	phr a m a h aa s o m^ p @@ ng^
พระยาอรรถการประสิทธิ์	phr a j aa z a t^ th a k aa n^ pr a s i t^
พระราชวรวงศ์เธอ	phr a r aa t^ ch a w @@ r a w o ng^ th qq
พระวรวงศ์เธอ	phr a w @@ r a w o ng^ th qq
พระสมุห์สมชาย	phr a s a m u s o m^ ch aa j^
พระสุวิทย์	phr a s u w i t^
พระอรรคชายาเธอ	phr a z a k^ kh a ch aa j aa th qq
พระอาจารย์สุดใจ	phr a z aa c aa n^ s u t^ c a j^
พระเจ้าบรมวงศ์เธอ	phr a c aa w^ b @@ r o m^ m a w o ng^ th qq
พระเจ้าราชวรวงศ์เธอ	phr a c aa w^ r aa t^ ch a w @@ r a w o ng^ th qq
พระเจ้าวรวงศ์เธอ	phr a c aa w^ w a r a w o ng^ th qq
พระเทพวิทยาคม	phr a th ee p^ w i t^ th a j aa kh o m^
พระไพศาล	phr a ph a j^ s aa n^
พรานเพชร	phr aa n^ ph ee t^
พริมรตา	phr i m^ r a t aa
พริมา	phr i m aa
พริษฐ์	phr i t^
พริ้ว	phr i w^
พรเทพ	ph @@ n^ th ee p^
พรเพชร	ph @@ n^ ph ee t^
พรเพ็ชร	ph @@ n^ ph e t^
พรเพ็ญ	ph @@ n^ ph e n^
พรไพร	ph @@ n^ phr a j^
พร้อม	phr @@ m^
พร้อมพงศ์	phr @@ m^ ph o ng^
พร้อมพงษ์	phr @@ m^ ph o ng^
พฤฒิชัย	phr v t^ th i ch a j^
พฤฒิรัตน์	phr v t^ th i r a t^
พฤหัส	ph a r v h a t^
พล	ph o n^
พลกฤษณ์	ph o n^ l a kr i t^
พลพล	ph a l a ph o n^
พลภูมิ	ph o n^ l a ph uu m^
พลรักษ์	ph o n^ r a k^
พลรัตน์	ph o n^ r a t^
พลวัฒน์	ph o n^ l a w a t^
พลอย	phl @@ j^
พลอยชมพู	phl @@ j^ ch o m^ ph uu
พลอยลภัส	phl @@ j^ l a ph a t^
พลอยไพลิน	phl @@ j^ ph a j^ l i n^
พลังชัย	ph a l a ng^ ch a j^
พลังธรรม	ph a l a ng^ th a m^
พลังพล	ph a l a ng^ ph o n^
พลากร	ph a l aa k @@ n^
พลายน้อย	phl aa j^ n @@ j^
พลเดช	ph o n^ d ee t^
พวงเล็ก	ph uua ng^ l e k^
พศ	ph o t^
พศวีร์	ph o t^ s a w ii
พศุตม์	ph a s u t^
พอล	ph @@ n^
พอลล่า	ph @@ n^ l aa
พอเจตน์	ph @@ c ee t^
พะเนียง	ph a n iia ng^
พะเยาว์	ph a j a w^
พัชชา	ph a t^ ch aa
พัชฏะ	ph a t^ ch a t a
พัชนี	ph a t^ ch a n ii
พัชรพล	ph a t^ ch a r a ph o n^
พัชรวลัย	ph a t^ ch a r a w a l a j^
พัชรวาท	ph a t^ ch a r a w aa t^
พัชรศรี	ph a t^ ch a r a s ii
พัชรา	ph a t^ ch a r aa
พัชราภรณ์	ph a t^ ch a r aa ph @@ n^
พัชราภา	ph a t^ ch a r aa ph aa
พัชริดา	ph a t^ ch a r i d aa
พัชรินทร์	ph a t^ ch a r i n^
พัชรี	ph a t^ ch a r ii
พัชรีย์	ph a t^ ch a r ii
พัฒนพล	ph a t^ th a n a ph o n^
พัฒนศักดิ์	ph a t^ th a n a s a k^
พัฒนา	ph a t^ th a n aa
พัฒน์	ph a t^
พัฒน์ชัย	ph a t^ ch a j^
พัณณิน	ph a n^ n i n^
พัณนิดา	ph a n^ n i d aa
พัดชา	ph a t^ ch aa
พัทธดนย์	ph a t^ th a d o n^
พัทธนันท์	ph a t^ th a n a n^
พัทธ์ธีรา	ph a t^ th ii r aa
พัทยา	ph a t^ th a j aa
พัน	ph a n^
พันกร	ph a n^ k @@ n^
พันทิวา	ph a n^ th i w aa
พันธุ์ทิพย์	ph a n^ th i p^
พันธุ์ศักดิ์	ph a n^ s a k^
พันธุ์เทพ	ph a n^ th ee p^
พันธ์ทิพย์	ph a n^ th i p^
พันธ์ศักดิ์	ph a n^ s a k^
พันนา	ph a n^ n aa
พัลลภ	ph a n^ l o p^
พัศชนันท์	ph a t^ 3s a ch a n a n^
พัสกร	ph a t^ s a k @@ n^
พัสวีพิชญ์	ph a t^ s a w ii ph i t^
พัสสน	ph a t^ s o n^
พาณิภัค	ph aa n i ph a k^
พาทิศ	ph aa th i t^
พานทองแท้	ph aa n^ th @@ ng^ th xx
พายัพ	ph aa j a p^
พายุ	ph aa j u
พารณ	ph aa r o n^
พาสนา	ph aa t^ s a n aa
พาเมล่า	ph aa m ee l aa
พิง	ph i ng^
พิจักขณา	ph i c a k^ kh a n aa
พิจิตต	ph i c i t^
พิจิตตรา	ph i c i t^ tr aa
พิจิตร	ph i c i t^
พิจิตรา	ph i c i t^ tr aa
พิชชา	ph i t^ ch aa
พิชชาภา	ph i t^ ch aa ph aa
พิชฌพัฒน์	ph i t^ ch a ph a t^
พิชญา	ph i t^ ch a j aa
พิชญาภา	ph i t^ ch a j aa ph aa
พิชญ์	ph i t^
พิชญ์นาฏ	ph i t^ ch a n aa t^
พิชย	ph i t^ ch a j a
พิชยดนย์	ph i t^ ch a j a d o n^
พิชัย	ph i ch a j^
พิชา	ph i ch aa
พิชาญเมธ	ph i ch aa n^ m ee t^
พิชาภา	ph i ch aa ph aa
พิชิต	ph i ch i t^
พิชิตพงษ์	ph i ch i t^ ph o ng^
พิตต้า	ph i t^ t aa
พิทยา	ph i t^ th a j aa
พิทักษ์	ph i th a k^
พิทักษ์ชัย	ph i th a k^ ch a j^
พิธิวัต	ph i th i w a t^
พินทุ์สุดา	ph i n^ th u s u d aa
พินิจ	ph i n i t^
พิพัฒน์	ph i ph a t^
พิภพ	ph i ph o p^
พิมณัฏฐา	ph i m^ n a t^ th aa
พิมดาว	ph i m^ d aa w^
พิมประภา	ph i m^ pr a ph aa
พิมพา	ph i m^ ph aa
พิมพิชยา	ph i m^ ph i t^ ch a j aa
พิมพ์	ph i m^
พิมพ์จิรา	ph i m^ c i r aa
พิมพ์ชนก	ph i m^ ch a n o k^
พิมพ์ญาดา	ph i m^ j aa d aa
พิมพ์นารา	ph i m^ n aa r aa
พิมพ์นิชกุล	ph i m^ n i t^ ch a k u n^
พิมพ์นิภา	ph i m^ n i ph aa
พิมพ์ปวีณ์	ph i m^ p a w ii n^ n a w o ng^
พิมพ์ผกา	ph i m^ ph a k aa
พิมพ์พรรณ	ph i m^ ph a n^
พิมพ์พัชร	ph i m^ ph a t^ ch a r a
พิมพ์มาดา	ph i m^ m aa d aa
พิมพ์รดาภา	ph i m^ r a d aa ph aa
พิมพ์ลดา	ph i m^ l a d aa
พิมพ์ลักษณ์	ph i m^ l a k^
พิมพ์ศิรี	ph i m^ s i r ii
พิมพ์เพ็ญ	ph i m^ ph e n^
พิมพ์แข	ph i m^ kh xx
พิมพ์ใจ	ph i m^ c a j^
พิมรภัส	ph i m^ r a ph a t^
พิมรา	ph i m^ r aa
พิมล	ph i m o n^
พิมลรัตน์	ph i m o n^ r a t^
พิมลวรรณ	ph i m o n^ w a n^
พิมศิริ	ph i m^ s i r i
พิยดา	ph i j a d aa
พิรดา	ph i r a d aa
พิรพัฒน์	ph i r a ph a t^
พิรัชต์	ph i r a t^
พิราพร	ph i r aa ph @@ n^
พิรุณ	ph i r u n^
พิศณุ	ph i t^ s a n u
พิศมัย	ph i t^ s a m a j^
พิศวาท	ph i t^ s a w aa t^
พิศาล	ph i s aa n^
พิศาลสิน	ph i s aa n^ s i n^
พิษณุ	ph i t^ s a n u
พิสมัย	ph i t^ s a m a j^
พิสิฐพงศ์	ph i s i t^ ph o ng^
พิสิษฐ์	ph i s i t^
พิสุทธิ์	ph i s u t^
พิเชฐ	ph i ch ee t^
พิเชษฐ	ph i ch ee t^
พิเชษฐ์	ph i ch ee t^
พิเศษ	ph i s ee t^
พิไล	ph i l a j^
พิไลพรรณ	ph i l a j^ ph a n^
พี	ph ii
พีชญา	ph ii t^ ch a j aa
พีท	ph ii t^
พีรฉัตร	ph ii r a ch a t^
พีรชยา	ph ii r a ch a j aa
พีรดนย์	ph ii r a d a n ee
พีรทรรศน์	ph ii r a th a t^
พีรพงศ์	ph ii r a ph o ng^
พีรพล	ph ii r a ph o n^
พีรพัชร	ph ii r a ph a t^ ch a r a
พีรพัฒน์	ph ii r a ph a t^
พีรพันธุ์	ph ii r a ph a n^
พีรยศ	ph ii r a j o t^
พีรวัศ	ph ii r a w a t^
พีรวัส	ph ii r a w a s^
พีรวิชญ์	ph ii r a w i t^
พีรสันติ	ph ii r a s a n^ t i
พีระ	ph ii r a
พีระพงษ์	ph ii r a ph o ng^
พีระพล	ph ii r a ph o n^
พีระพัฒน์	ph ii r a ph a t^
พีระพันธุ์	ph ii r a ph a n^
พีระเกียรติ	ph ii r a k iia t^
พีระเทพ	ph ii r a th ee p^
พีระเพชร	ph ii r a ph e t^
พุฒ	ph u t^
พุฒิชัย	ph u t^ th i ch a j^
พุฒิพงศ์	ph u t^ th i ph o ng^
พุทธชาด	ph u t^ th a ch aa t^
พุทธินันท์	ph u t^ th i n a n^
พุทธิพงษ์	ph u t^ th i ph o ng^
พุธิตา	ph u t^ t aa
พุ่ม	ph u m^
พุ่มพวง	ph u m^ ph uua ng^
พูน	ph uu n^
พูนภิรมย์	ph uu n^ ph i r o m^
พูนศุข	ph uu n^ s u k^
พูนสวัสดิ์	ph uu n^ s a w a t^
พูนสุข	ph uu n^ s u k^
พเยาว์	ph a j a w^
พ็ญแข	ph e n^ kh xx
พ่อท่านเอื้อม	ph @@ th aa n^ z vva m^
พ้อง	ph @@ ng^
ฟร้อนท์	fr @@ n^
ฟลอเรนซ์	fl @@ r ee n^
ฟองจันทร์	f @@ ng^ c a n^
ฟองสนาน	f @@ ng^ s a n aa n^
ฟาริดา	f aa r i d aa
ฟีฟี่	f ii f ii
ฟื้น	f vv n^
ฟ้าคะนอง	f aa kh a n @@ ng^
ฟ้าคำรณ	f aa kh a m^ r o n^
ฟ้าประกอบ	f aa pr a k @@ p^
ฟ้ารุ่ง	f aa r u ng^
ฟ้าลั่น	f aa l a n^
ฟ้าลั่นจูเนียร์	f aa l a n^ c uu n iia
ฟ้าสั่ง	f aa s a ng^
ฟ้าสีทอง	f aa s ii th @@ ng^
ฟ้าเพชรน้อย	f aa ph e t^ n @@ j^
ฟ้าใส	f aa s a j^
ภคกัญญา	ph a kh a k a n^ j aa
ภคมน	ph a kh o m^
ภควัฒน์	ph a kh a w a t^
ภคิน	ph a kh i n^
ภรณ์ทิพย์	ph @@ n^ th i p^
ภรภัทร	ph @@ r a ph a t^
ภรัณยู	ph a r a n^ j uu
ภราดร	ph a r aa d @@ n^
ภวัต	ph a w a t^
ภักดี	ph a k^ d ii
ภักดีหาญส์	ph a k^ d ii h aa n^
ภัคจิรา	ph a k^ c i r aa
ภัคจีรา	ph a k^ c ii r aa
ภัคพร	ph a k^ kh a ph @@ n^
ภัครมัย	ph a k^ kh a r a m a j^
ภัควรรธน์	ph a k^ kh a w a t^
ภัคศรุจน์	ph a k^ kh a s a r u t^
ภัชธร	ph a t^ ch a th @@ n^
ภัณฑิลา	ph a n^ th i l aa
ภัททพล	ph a t^ th a ph o n^
ภัทร	ph a t^
ภัทรกร	ph a t^ thr a k @@ n^
ภัทรธิดา	ph a t^ th i d aa
ภัทรนันท์	ph a t^ th a r a n a n^
ภัทรนิษฐ์	ph a t^ th a r a n i t^
ภัทรพล	ph a t^ th a r a ph o n^
ภัทรวดี	ph a t^ th a r a w a d ii
ภัทรวรินทร์	ph a t^ th a r a w a r i n^
ภัทรวี	ph a t^ th a r a w ii
ภัทรวุฒิ	ph a t^ th a r a w u t^
ภัทรศยา	ph a t^ s a j aa
ภัทรศักดิ์	ph a t^ th a r a s a k^
ภัทรสุดา	ph a t^ th a r a s u d aa
ภัทรากร	ph a t^ th a r aa k @@ n^
ภัทรานิษฐ์	ph a t^ thr aa n i t^
ภัทราพร	ph a t^ thr aa ph @@ n^
ภัทราริน	ph a t^ thr aa r i n^
ภัทราวดี	ph a t^ th aa w a d ii
ภัทรินทร์	ph a t^ th a r i n^
ภัทรเดช	ph a t^ th a r a d ee t^
ภัสธรากรณ์	ph a t^ s a th a r aa k @@ n^
ภัสสร	ph a t^ s @@ n^
ภัสสรกรณ์	ph a t^ s a r a k @@ n^
ภากร	ph aa k @@ n^
ภาคภูมิ	ph aa k^ ph uu m^
ภาคิน	ph aa kh i n^
ภาคใต้	ph aa k^ t a j^
ภาณิศา	ph aa n i s aa
ภาณุ	ph aa n u
ภาณุพงศ์	ph aa n u ph o ng^
ภาณุพล	ph aa n u ph o n^
ภาณุเดช	ph aa n u d ee t^
ภาธร	ph aa th @@ n^
ภานุทัต	ph aa n u th a t^
ภานุพงศ์	ph aa n u ph o ng^
ภานุวัฒน์	ph aa n u w a t^
ภารดี	ph aa r a d ii
ภาราดา	ph aa r aa d aa
ภาลฎา	ph aa l a d aa
ภาวดี	ph aa w a d ii
ภาวนา	ph aa w a n aa
ภาวิช	ph aa w i t^
ภาวิณี	ph aa w i n ii
ภาษิต	ph aa s i t^
ภิญญา	ph i n^ j aa
ภิญญาพัชญ์	ph i n^ j aa ph a t^
ภิญโญ	ph i n^ j oo
ภิรพล	ph i r a ph o n^
ภิรมย์	ph i r o m^
ภีมพล	ph ii m^ ph o n^
ภีรนีย์	ph ii r a n ii
ภีรภัทร์	ph ii r a ph a t^
ภุชงค์	ph u ch o ng^
ภุชพงศ์	ph u t^ ph o ng^
ภุชิสสะ	ph u ch i t^ s a
ภูธฤทธิ์	ph uu th a r i t^
ภูธเนศ	ph uu th a n ee t^
ภูผา	ph uu ph aa
ภูภูมิ	ph uu ph uu m^
ภูมิ	ph uu m^
ภูมินทร์	ph uu m i n^
ภูมิพัฒน์	ph uu m i ph a t^
ภูมิสิทธิ์	ph uu m i s i t^
ภูริ	ph uu r i
ภูริกูลกฤษฎ์	ph uu r i k uu n^ kr i t^
ภูริช	ph uu r i t^
ภูริต	ph uu r i t^
ภูริทัต	ph uu r i th a t^
ภูริวัชร์	ph uu r i w a t^
ภูวดล	ph uu w a d o n^
ภูวนาท	ph uu w a n aa t^
ภูวนิดา	ph uu w a n i d aa
ภูวรินทร์	ph uu w a r i n^
ภูวินทร์	ph uu w i n^
ภูศิลป์	ph uu s i n^
ภูษณ	ph uu s o n^
ภูษณะ	ph uu s a n a
ภูษิต	ph uu s i t^
ภูหิรัณย์	ph uu h i r a n^
มงคล	m o ng^ kh o n^
มชณต	m @@ ch @@ n o t^
มณฑล	m o n^ th o n^
มณฑารัตน์	m o n^ th aa r a t^
มณฑินี	m o n^ th i n ii
มณฑิรา	m o n^ th i r aa
มณฑิลา	m o n^ th i l aa
มณทิพย์	m o n^ th i p^
มณี	m a n ii
มณีพงศ์	m a n ii ph o ng^
มณีภัสสร	m a n ii ph a t^ s @@ n^
มณีรัตน์	m a n ii r a t^
มณเฑียร	m o n^ th iia n^
มด	m o t^
มทิรา	m a th i r aa
มนตรี	m o n^ tr ii
มนต์ชัย	m o n^ ch a j^
มนต์ดำ	m o n^ d a m^
มนต์รัก	m o n^ r a k^
มนต์สยาม	m o n^ s a j aa m^
มนต์สิทธิ์	m o n^ s i t^
มนต์แคน	m o n^ kh xx n^
มนทกานติ์	m o n^ th a k aa n^
มนธภูมิ	m o n^ th a ph uu m^
มนพร	m a n a ph @@ n^
มนภัทร	m a n a ph a t^
มนฤดี	m a n a r v d ii
มนสภรณ์	m o n^ s a ph @@ n^
มนัญญา	m a n a n^ j aa
มนัส	m a n a t^
มนัสนันท์	m a n a t^ n a n^
มนัสวีร์	m a n a t^ w ii
มนุชญ์	m a n u t^
มนูญกฤต	m a n uu n^ kr i t^
มยุรา	m a j u r aa
มยุริญ	m a j u r i n^
มรกต	m @@ r a k o t^
มริภา	m a r i ph aa
มรุต	m a r u t^
มลิกา	m a l i k aa
มหาสมุทร	m a h aa s a m u t^
มอนอินทร์	m @@ n^ z i n^
มอริส	m @@ r i t^
มัณฑนา	m a n^ th a n aa
มัทนี	m a t^ n ii
มัม	m a m^
มัลลิกา	m a n^ l i k aa
มั่น	m a n^
มาช่า	m aa ch aa
มาติกา	m aa t i k aa
มานพ	m aa n o p^
มานะ	m aa n a
มานะศักดิ์	m aa n a s a k^
มานิดา	m aa n i d aa
มานิต	m aa n i t^
มานิตย์	m aa n i t^
มานี	m aa n ii
มารยาท	m aa r a j aa t^
มารวย	m aa r uua j^
มารศรี	m aa r a s ii
มาริสา	m aa r i s aa
มาริโอ้	m aa r i z oo
มารี	m aa r ii
มารีญา	m aa r ii j aa
มารีออน	m aa r ii z @@ n^
มารุต	m aa r u t^
มาร์ค	m aa k^
มาร์โค	m aa kh oo
มาลัย	m aa l a j^
มาลัยทอง	m aa l a j^ th @@ ng^
มาลัยเพชร	m aa l a j^ ph ee t^
มาลา	m aa l aa
มาลินี	m aa l i n ii
มาลี	m aa l ii
มาลีรัตน์	m aa l ii r a t^
มาลีวัลย์	m aa l ii w a n^
มาวิน	m aa w i n^
มาสุ	m aa s u
มาเรียม	m aa r iia m^
มาเล็ก	m aa l e k^
มาโนช	m aa n oo t^
มาโนชญ์	m aa n oo t^
มาไพ	m aa ph a j^
มิก้า	m i k aa
มิณฑิตา	m i n^ th i t aa
มิณทร์	m i n^ s
มิตร	m i t^
มิรา	m i r aa
มิลิน	m i l i n^
มิเชล	m i ch ee n^
มิ่งกมล	m i ng^ k a m o n^
มิ่งขวัญ	m i ng^ khw a n^
มีชัย	m ii ch a j^
มีนาพร	m ii n aa ph @@ n^
มีมี่	m ii m ii
มีศักดิ์	m ii s a k^
มีสุข	m ii s u k^
มุกดา	m u k^ d aa
มุข	m u k^
มุขพล	m u k^ ph o n^
มุนินทร์	m u n i n^
มุนี	m u n ii
มุสซา	m u t^ s aa
มุสตากีม	m u t^ s a t aa k ii m^
มูฮัมหมัด	m uu h a m^ m a t^
มูฮำมัดอารีฟีน	m uu h a m^ m a t^ z aa r ii f ii n^
ม่านฟ้า	m aa n^ f aa
ยก	j o k^
ยง	j o ng^
ยงยศ	j o ng^ j o t^
ยงยุทธ	j o ng^ j u t^
ยรรยง	j a n^ j o ng^
ยลดา	j o n^ l a d aa
ยวง	j uua ng^
ยศ	j o t^
ยศพล	j o t^ s a ph o n^
ยศวดี	j o t^ s a w a d ii
ยศวริศ	j o t^ s a w a r i t^
ยอด	j @@ t^
ยอดขวัญ	j @@ t^ khw a n^
ยอดขุนพล	j @@ t^ kh u n^ ph o n^
ยอดชาญชัย	j @@ t^ ch aa n^ ch a j^
ยอดชิงชัย	j @@ t^ ch i ng^ ch a j^
ยอดดอย	j @@ t^ d @@ j^
ยอดดำรงค์	j @@ t^ d a m^ r o ng^
ยอดธง	j @@ t^ th o ng^
ยอดมงคล	j @@ t^ m o ng^ kh o n^
ยอดมนู	j @@ t^ m a n uu
ยอดยุทธ	j @@ t^ j u t^
ยอดรัก	j @@ t^ r a k^
ยอดสนั่น	j @@ t^ s a n a n^
ยอดสิงห์	j @@ t^ s i ng^
ยอดสิงห์แดง	j @@ t^ s i ng^ d xx ng^
ยอดเงิน	j @@ t^ ng q n^
ยอดแสนเก่ง	j @@ t^ s xx n^ k e ng^
ยอดแสนไกล	j @@ t^ s xx n^ kl a j^
ยอแซฟ	j @@ s xx p^
ยัง	j a ng^
ยิ่งพันธ์	j i ng^ ph a n^
ยิ่งยง	j i ng^ j o ng^
ยิ่งลักษณ์	j i ng^ l a k^
ยิ่งศักดิ์	j i ng^ s a k^
ยืน	j vv n^
ยืนยง	j vv n^ j o ng^
ยุกต์	j u k^
ยุคล	j u kh o n^
ยุทธ	j u t^
ยุทธจักร	j u t^ th a c a k^
ยุทธนา	j u t^ th a n aa
ยุทธพงศ์	j u t^ th a ph o ng^
ยุทธพงษ์	j u t^ th a ph o ng^
ยุทธพร	j u t^ th a ph @@ n^
ยุทธพล	j u t^ th a ph o n^
ยุทธพิชัย	j u t^ th a ph i ch a j^
ยุทธศักดิ์	j u t^ th a s a k^
ยุทธเลิศ	j u th a l qq t^
ยุทธ์	j u t^
ยุพราช	j u p^ ph a r aa t^
ยุพา	j u ph aa
ยุรนันท์	j u r a n a n^
ยุวดี	j u w a d ii
ยุวนัฏ	j u w a n a t^
ยุวรัตน์	j u w a r a t^
ยุ้ย	j u j^
ยูชิ	j uu ch i
ยูมิโกะ	j uu m i k o
รงค์	r o ng^
รจนา	r o t^ c a n aa
รชฏ	r a ch o t^
รชต	r a ch o t^
รชนีกร	r o t^ ch a n ii k @@ n^
รชยา	r a ch a j aa
รฐา	r a th aa
รณ	r o n^
รณชัย	r o n^ n a ch a j^
รณภพ	r o n^ n a ph o p^
รณวีร์	r o n^ n a w ii
รณิดา	r a n i d aa
รดมยศ	r @@ d o m^ j o t^
รตวรรณ	r a t a w a n^
รติพงษ์	r a t i ph o ng^
รติพันธ์	r a t i ph a n^
รถถัง	r o t^ th a ng^
รพีภัทร	r a ph ii ph a t^
รมิดา	r a m i d aa
รวงทอง	r uua ng^ th @@ ng^
รวมศักดิ์	r uua m^ s a k^
รวิช	r a w i t^
รวิชญ์	r a w i t^
รวินดา	r a w i n^ d aa
รวิวรรณ	r a w i w a n^
รวี	r a w ii
รสนา	r o t^ s a n aa
รอง	r @@ ng^
ระดับดาว	r a d a p^ d aa w^
ระนองรักษ์	r a n @@ ng^ r a k^
ระพิน	r a ph i n^
ระพิพรรณ	r a ph i ph a n^
ระพี	r a ph ii
ระวี	r a w ii
ระเบียบ	r a b iia p^
ระเบียบรัตน์	r a b iia p^ r a t^
รักชาติ	r a k^ ch aa t^
รักนิรันดร์	r a k^ n i r a n^
รักษิตา	r a k^ s i t aa
รักษ์	r a k^
รักษ์สุดา	r a k^ s u d aa
รักเกียรติ	r a k^ k iia t^
รังษี	r a ng^ s ii
รังสรรค์	r a ng^ s a n^
รังสฤทธิ์	r a ng^ s a r i t^
รังสาทย์	r a ng^ s aa t^
รังสิกานต์	r a ng^ s i k aa n^
รังสิญา	r a ng^ s i j aa
รังสิต	r a ng^ s i t^
รังสิมา	r a ng^ s i m aa
รังสิโรจน์	r a ng^ s i r oo t^
รัจนา	r a t^ c a n aa
รัชชานนท์	r a t^ ch aa n o n^
รัชชุ	r a t^ ch u
รัชฎาภรณ์	r a t^ ch a d aa ph @@ n^
รัชดา	r a t^ ch a d aa
รัชต์ยุตม์	r a t^ j u t^
รัชนก	r a t^ ch a n o k^
รัชนี	r a t^ ch a n ii
รัชพล	r a t^ ch a ph o n^
รัชย์ณมนทร์	r a t^ n^ m ee n^
รัชวิน	r a t^ ch a w i n^
รัชเดช	r a t^ ch a d ee t^
รัชโยธิน	r a t^ ch a j oo th i n^
รัญญา	r a n^ j aa
รัญดภา	r a n^ d a ph aa
รัฐกร	r a t^ th a k @@ n^
รัฐกิจ	r a t^ th a k i t^
รัฐธรรมนูญ	r a t^ th a th a m^ m a n uu n^
รัฐพงศ์	r a t^ th a ph o ng^
รัฐภาคย์	r a t^ ph aa k^
รัฐภูมิ	r a t^ th a ph uu m^
รัฐวิทย์	r a t^ th a w i t^
รัฐศาสตร์	r a t^ th a s aa t^
รัดเกล้า	r a t^ kl aa w^
รัตติกร	r a t^ t i k @@ n^
รัตติกาล	r a t^ t i k aa n^
รัตนชัย	r a t^ t a n a ch a j^
รัตนพล	r a t^ t a n a ph o n^
รัตนรัตน์	r a t^ t a n a r a t^
รัตนา	r a t^ t a n aa
รัตนากร	r a t^ t a n aa k @@ n^
รัตนาพร	r a t^ t a n aa ph @@ n^
รัตนาภรณ์	r a t^ t a n aa ph @@ n^
รัตนเดช	r a t^ t a n a d ee t^
รัตน์	r a t^
รัศมี	r a t^ s a m ii
รัสุพัตรา	r a t^ s u ph a t^ tr aa
ราชมงคล	r aa t^ ch a m o ng^ kh o n^
ราชวัติ	r aa t^ ch a w a t^
ราชิต	r aa ch i t^
ราณี	r aa n ii
ราม	r aa m^
รามณรงค์	r aa m^ n a r o ng^
รามา	r aa m aa
รามาวดี	r aa m aa w a d ii
ราวี	r aa w ii
ราศรี	r aa s ii
ราศี	r aa s ii
ราโมน่า	r aa m oo n aa
รำลึก	r a m^ l v k^
รำไพ	r a m^ ph a j^
ริกะ	r i k a
ริค	r i k^
รินทร์ดนัย	r i n^ d a n a j^
รินรดา	r i n^ r a d aa
รินลณี	r i n^ l a n ii
ริสา	r i s aa
รุจนา	r u c a n aa
รุจน์	r u t^
รุจิกร	r u c i k @@ n^
รุจิราภรณ์	r u c i r aa ph @@ n^
รุษยา	r u t^ s a j aa
รุสลี	r u t^ s a l ii
รุ่ง	r u ng^
รุ่งธรรม	r u ng^ th a m^
รุ่งนภา	r u ng^ n a ph aa
รุ่งรัฐ	r u ng^ r a t^
รุ่งรัตน์	r u ng^ r a t^
รุ่งเพชร	r u ng^ ph ee t^
รุ่งเรือง	r u ng^ r vva ng^
รุ่งโรจน์	r u ng^ r oo t^
รุ้งนภัฐ	r u ng^ n a ph a t^
รุ้งลาวัณย์	r u ng^ l aa w a n^
รุ้งลาวัลย์	r u ng^ l aa w a n^
รุ้งเฑียร	r u ng^ th iia n^
ร็อคกี้	r @ k^ k ii
ร่มเกล้า	r o m^ kl a w^
ฤกษ์ชัย	r qq k^ ch a j^
ฤกษ์ฤทธิ์	r qq k^ r i t^
ฤทธิ	r i t^ th i
ฤทธิชัย	r i t^ th i ch a j^
ฤทธิพร	r i t^ th i ph @@ n^
ฤทธิเดช	r i t^ th i d ee t^
ฤทธิ์	r i t^
ฤทัย	r v th a j^
ฤทัยชนก	r v th a j^ ch a n o k^
ลดาวัลย์	l a d aa w a n^
ลดาวัลลิ์	l a d aa w a n^
ลพ	l o p^
ลภัสภร	l a ph a t^ ph @@ n^
ลภัสรดา	l a ph a t^ r a d aa
ลภัสลัล	l a ph a t^ l a n^
ลลนา	l a l a n aa
ลลิตา	l a l i t aa
ลลินา	l a l i n aa
ลลิษา	l a l i s aa
ละออง	l a z @@ ng^
ละอองดาว	l a z @@ ng^ d aa w^
ละอองเพชร	l a z @@ ng^ ph ee t^
ละเมียน	l a m iia n^
ละเอียด	l a z iia t^
ลักขณา	l a k^ kh a n aa
ลักษณ์	l a k^
ลักษิกา	l a k^ s i k aa
ลัคนา	l a k^
ลัลณ์ลลิน	l a n^ n^ l i n^
ลานนา	l aa n^ n aa
ลาภศักดิ์	l aa p^ s a k^
ลาภิสรา	l aa ph i t^ s a r aa
ลำน้ำพอง	l a m^ n aa m^ ph @@ ng^
ลำยอง	l a m^ j @@ ng^
ลิขิต	l i kh i t^
ลิงลม	l i ng^ l o m^
ลิซ่า	l i s aa
ลินดา	l i n^ d aa
ลินทร์พิตา	l i n^ ph i t aa
ลี	l ii
ลีนา	l ii n aa
ลีน่า	l ii n aa
ลีลาวดี	l ii l aa w a d ii
ลีโอ	l ii z oo
ลือชัย	l vv ch a j^
ลูกนก	l uu k^ n o k^
ลูกน้ำ	l uu k^ n aa m^
ลูกรัก	l uu k^ r a k^
ล้อม	l @@ m^
ล้ำ	l a m^
วงศกร	w o ng^ s a k @@ n^
วงศ์	w o ng^
วงศ์ทนง	w o ng^ th a n o ng^
วงศ์ศักดิ์	w o ng^ s a k^
วงศ์เมือง	w o ng^ m vva ng^
วงเดือน	w o ng^ d vva n^
วชิรวิชญ์	w a ch i r a w i t^
วชิระกฤช	w a ch i r a kr i t^
วชิระมณฑ์	w a ch i r a m o n^
วฑูศิริ	w a th uu s i r i
วณิชยา	w a n i t^ ch a j aa
วทัญญู	w a th a n^ j uu
วนัฏษญา	w a n a t^ s a j aa
วนัสธนา	w a n a t^ th a n aa
วนิช	w a n i t^
วนิดา	w a n i d aa
วรกมล	w @@ r a k a m o n^
วรกร	w @@ r a k @@ n^
วรกาญจน์	w @@ r a k aa n^
วรงค์	w a r o ng^
วรชัย	w @@ r a ch a j^
วรชิต	w @@ r a ch i t^
วรนันท์	w @@ r a n a n^
วรนิษฐ์	w @@ r a n i t^
วรนุช	w @@ r a n u t^
วรพจน์	w @@ r a ph o t^
วรพรต	w @@ n^ phr o t^
วรพล	w @@ r a ph o n^
วรพันธุ์	w @@ r a ph a n^
วรภร	w @@ r a ph @@ n^
วรภัสสร	w @@ r a ph a t^ s @@ n^
วรรณ	w a n^
วรรณปิยะ	w a n^ n a p i j a
วรรณพร	w a n^ n a ph @@ n^
วรรณรท	w a n^ r ee t^
วรรณรัตน์	w a n^ n a r a t^
วรรณฤดี	w a n^ n a r v d ii
วรรณวลัย	w a n^ w a l a j^
วรรณวัฒน์	w a n^ n a w a t^
วรรณวิมล	w a n^ w i m o n^
วรรณศรี	w a n^ n a s ii
วรรณษา	w a n^ n a s aa
วรรณา	w a n^ n aa
วรรณไว	w a n^ n a w a j^
วรรธนา	w a n^ th a n aa
วรรษพร	w a t^ s a ph @@ n^
วรรษมณฑ์	w a t^ s a m o n^
วรรษมน	w a t^ s a m o n^
วรรัตน์	w @@ r a r a t^
วรฤทธิ์	w @@ r a r i t^
วรวงษ์	w @@ r a w o ng^
วรวัจน์	w @@ r a w a t^
วรวิทย์	w @@ r a w i t^
วรวีร์	w @@ r a w ii
วรวุฒิ	w @@ r a w u t^
วรศักดิ์	w @@ r a s a k^
วรศุลี	w @@ r a s u l ii
วรัชญา	w a r a t^ ch a j aa
วรัญชัย	w a r a n^ ch a j^
วรัญญา	w a r a n^ j aa
วรัทยา	w a r a t^ th a j aa
วรัลชญาน์	w a r a n^ ch a j aa
วรางคณา	w a r aa ng^ kh a n aa
วรางคณิภา	w a r aa ng^ kh a n i ph aa
วรานิษฐ์	w a r aa n i t^
วรานุช	w a r aa n u t^
วราพรรณ	w a r aa ph a n^
วราภรณ์	w a r aa ph @@ n^
วราภัทร์	w a r aa ph a t^
วรายุฑ	w a r aa j u t^
วรารัตน์	w a r aa r a t^
วราลักษณ์	w a r aa w a l a k^
วราวงษ์	w a r aa w o ng^
วราวุธ	w a r aa w u t^
วราเทพ	w a r aa th ee p^
วริฏฐิสา	w a r i t^ th i s aa
วรินทร	w a r i n^ th @@ n^
วรินทร์ลดา	w a r i n^ l a d aa
วริศ	w a r i t^
วริษฐ์	w a r i t^
วรุฒ	w a r u t^
วรุตม์	w a r u t^
วรเจตน์	w @@ r a c ee t^
วรเชษฐ์	w @@ r a ch ee t^
วรเวช	w @@ r a w ee t^
วฤษฎิ์	w a r i t^
วลันลักษณ์	w a l a n^ l a k^
วลีพร	w a l ii ph @@ n^
วศิน	w a s i n^
วศิษฏ์	w a s i t^
วสันต์	w a s a n^
วสิษฐ	w a s i t^
วสุ	w a s u
วังจั่นน้อย	w a ng^ c a n^ n @@ j^
วังพนม	w a ng^ ph a n o m^
วัชรกร	w a t^ ch a r a k @@ n^
วัชรชัย	w a t^ ch a r a ch a j^
วัชรบูล	w a t^ ch a r a b uu n^
วัชรพล	w a t^ ch a r a ph o n^
วัชรพันธ์	w a t^ ch a r a ph a n^
วัชระ	w a t^ ch a r a
วัชรากร	w a t^ ch a r aa k @@ n^
วัชราภรณ์	w a t^ ch a r aa ph @@ n^
วัชรารัศมี	w a t^ ch a r aa r a t^ s a m ii
วัชรินทร์	w a t^ ch a r i n^
วัชรียา	w a t^ ch a r ii j aa
วัชรเกียรติ	w a t^ ch a r a k iia t^
วัฒนชัย	w a t^ th a n a ch a j^
วัฒนา	w a t^ th a n aa
วัฒน์	w a t^
วัน	w a n^
วันชนะ	w a n^ ch a n a
วันชัย	w a n^ ch a j^
วันดี	w a n^ d ii
วันธงชัย	w a n^ th o ng^ ch a j^
วันมีโชค	w a n^ m ii ch oo k^
วันมูหะมัดนอร์	w a n^ m uu h a m a t^ n @@
วันวิน	w a n^ w i n^
วันอับดุลกาเดร์	w a n^ z a p^ d u n^ k aa d ee
วันเฉลิม	w a n^ ch a l qq m^
วันเพ็ญ	w a n^ ph e n^
วันเฮง	w a n^ h e ng^
วัยโรจน์	w a j^ r oo t^
วัลภา	w a n^ l a ph aa
วัลลภ	w a n^ l o p^
วัลลี	w a n^ l ii
วัลเณซ่า	w a n^ n ee s aa
วาณิช	w aa n i t^
วาทิต	w aa th i t^
วาทิน	w aa th i n^
วานิช	w aa n i t^
วารินทร์	w aa r i n^
วารุจ	w aa r u t^
วาสนา	w aa t^ s a n aa
วาสิต	w aa s i t^
วาสุเทพ	w aa s u th ee p^
วาเนสซา	w aa n ee s^ s aa
วาเนสซ่า	w aa n ee s^ s aa
วิกรม	w i kr o m^
วิจันทรา	w i c a n^ thr aa
วิจารณ์	w i c aa n^
วิจิตร	w i c i t^
วิจิตรา	w i c i t^ tr aa
วิชชพัชร์	w i t^ ch a ph a t^
วิชชาธร	w i t^ ch aa th @@ n^
วิชชุดา	w i t^ ch u d aa
วิชช์	w i
วิชญาณี	w i t^ ch a j aa n ii
วิชญ์	w i t^ ch a
วิชญ์พล	w i t^ ph o n^
วิชญ์วิสิฐ	w i t^ ch a w i s i t^
วิชยา	w i t^ ch a j aa
วิชยุตม์	w i t^ ch a j u t^
วิชะยา	w i ch a j aa
วิชัย	w i ch a j^
วิชา	w i ch aa
วิชาญ	w i ch aa n^
วิชาญน้อย	w i ch aa n^ n @@ j^
วิชิต	w i ch i t^
วิชุดา	w i ch u d aa
วิชเวช	w i t^ ch a w ee t^
วิญญู	w i n^ j uu
วิฑูรย์	w i th uu n^
วิถี	w i th ii
วิทยา	w i t^ th a j aa
วิทยากร	w i t^ th a j aa k @@ n^
วิทยาน้อย	w i t^ th a j aa n @@ j^
วิทย์สรัช	w i t^ s a r a t^
วิทวัส	w i t^ th a w a t^
วิทัย	w i th a j^
วิทิต	w i th i t^
วิทิตนันท์	w i th i t^ n a n^
วิทเยนทร์	w i t^ j ee n^
วินทร์	w i n^
วินธัย	w i n^ th a j^
วินยู	w i n^ j uu
วินรวีร์	w i n^ r a w ii
วินัย	w i n a j^
วินิจ	w i n i t^
วินิตา	w i n i t aa
วินเซ็นต์	w i n^ s e n^
วิบูลย์	w i b uu n^
วิภาดา	w i ph aa d aa
วิภาต	w i ph aa t^
วิภาวรรณ	w i ph aa w a n^
วิภาวี	w i ph aa w ii
วิภาส	w i ph aa t^
วิภูแถลง	w i ph uu th a l xx ng^
วิมล	w i m o n^
วิมลศิริ	w i m o n^ s i r i
วิรดา	w i r a d aa
วิระยา	w i r a j aa
วิรัช	w i r a t^
วิรัตน์	w i r a t^
วิรากานต์	w i r aa k aa n^
วิรายา	w i r aa j aa
วิริฒิพา	w i r i th i ph aa
วิรุฬ	w i r u n^
วิรุฬห์	w i r u n^
วิรไท	w i r a th a j^
วิลลี่	w i n^ l ii
วิลัยพร	w i l a j^ ph @@ n^
วิลาวัณย์	w i l aa w a n^
วิลาศ	w i l aa t^
วิลาสินี	w i l aa s i n ii
วิลเลียม	w i n^ l iia m^
วิวรรธนไชย	w i w a t^ th a n a ch a j^
วิวัฒน์	w i w a t^
วิวิศน์	w i w i t^
วิศณุ	w i t^ s a n u
วิศรุต	w i t^ s a r u t^
วิศาล	w i s aa n^
วิศิษฏ์	w i s i t^
วิศิษฐ์	w i s i t^
วิษณุ	w i t^ s a n u
วิษณุศักดิ์	w i t^ s a n u s a k^
วิษุวัต	w i t^ s u w a t^
วิสันต์	w i s a n^
วิสา	w i s aa
วิสาร	w i s aa n^
วิสาระดี	w i s aa r a d ii
วิสิทธิ์	w i s i t^
วิสุทธิ์	w i s u t^
วิหค	w i h o k^
วิเชษฐ์	w i ch ee t^
วิเชียร	w i ch iia n^
วิเศษ	w i s ee t^
วิโรจน์	w i r oo t^
วิโรฒ	w i r oo t^
วิโอเลต	w i z oo l e t^
วิไล	w i l a j^
วิไลลักษณ์	w i l a j^ l a k^
วิไลวรรณ	w i l a j^ w a n^
วีรคณิศร์	w ii r a kh a n i t^
วีรชน	w ii r a ch o n^
วีรชัย	w ii r a ch a j^
วีรชิต	w ii r a ch i t^
วีรพงษ์	w ii r a ph o ng^
วีรภัทร	w ii r a ph a t^
วีรภาพ	w ii r a ph aa p^
วีรยุทธ	w ii r a j u t^
วีรยุทธ์	w ii r a j u t^
วีรวร	w ii r a w @@ n^
วีรศักดิ์	w ii r a s a k^
วีระ	w ii r a
วีระกร	w ii r a k @@ n^
วีระกานต์	w ii r a k aa n^
วีระชัย	w ii r a ch a j^
วีระชัยศรีวณิก	w ii r a ch a j^ s ii w a n i k^
วีระชาติ	w ii r a ch aa t^
วีระนิด	w ii r a n i t^
วีระพล	w ii r a ph o n^
วีระพันธ์	w ii r a ph a n^
วีระยุทธ	w ii r a j u t^
วีระวัฒน์	w ii r a w a t^
วีระวุฒิ	w ii r a w u t^
วีระศักดิ์	w ii r a s a k^
วีระศักดิ์เล็ก	w ii r a s a k^ l e k^
วีระเดช	w ii r a d ee t^
วีระเทพ	w ii r a th ee p^
วีรัณ	w ii r a n^
วีรัส	w ii r a t^
วีรินทร์ทิรา	w ii r i n^ th i r aa
วีรินท์	w ii r i n^
วุฒิ	w u t^ th i
วุฒิชัย	w u t^ th i ch a j^
วุฒิธร	w u t^ th i th @@ n^
วุฒิพงศ์	w u t^ th i ph o ng^
วุฒิพงษ์	w u t^ th i ph o ng^
วุฒิพันธ์	w u t^ th i ph a n^
วุฒิศักดิ์	w u t^ th i s a k^
วุฒิสวาท	w u t^ th i s a w aa t^
วุฒิสิทธิ์	w u t^ th i s i t^
วโรดม	w a r oo d o m^
วโรทัย	w a r oo th a j^
ศกรณ์	s a k @@ n^
ศกลรัตน์	s a k o n^ r a t^
ศกุนตลา	s a k u n^ l aa
ศดานันท์	s a d aa n a n^
ศตวรรษ	s a t a w a t^
ศนันธฉัตร	s a n a n^ th a ch a t^
ศนุกรานต์	s a n u kr aa n^
ศยาพร	s a j aa ph @@ n^
ศรคม	s @@ n^ kh o m^
ศรคีรี	s @@ n^ kh ii r ii
ศรชัย	s @@ n^ ch a j^
ศรนารายณ์	s a r a n aa r aa j^
ศรพิชัย	s @@ n^ ph i ch a j^
ศรราม	s @@ n^ r aa m^
ศรศิลป์	s a r a s i n^
ศรสวรรค์	s @@ n^ s a w a n^
ศรัญ	s a r a n^
ศรัณยู	s a r a n^ j uu
ศรัณย่า	s a r a n^ j aa
ศรัณย์	s a r a n^
ศรัณย์รัชต์	s a r a n^ r a t^
ศรัณย์วุฒิ	s a r a n^ w u t^
ศรัท	s a t^
ศรันยู	s a r a n^ j uu
ศรานุวัฒน์	s a r aa n u w a t^
ศรายุทธ	s a r aa j u t^
ศราวิน	s a r aa w i n^
ศราวุฒิ	s a r aa w u t^
ศราวุธ	s a r aa w u t^
ศรินทิพย์	s a r i n^ th i p^
ศรีคูณ	s ii kh uu n^
ศรีธัญญา	s ii th a n^ j aa
ศรีพรรณ	s ii ph a n^
ศรีรัศมิ์	s ii r a t^
ศรีริต้า	s ii r i t aa
ศรีวราห์	s ii w a r aa
ศรีศักร	s ii s a k^ k a r a
ศรีสกุล	s ii s a k u n^
ศรีสะเกษ	s ii s a k ee t^
ศรีสุข	s ii s u k^
ศรีสุดา	s ii s u d aa
ศรีสุภางค์	s ii s u ph aa ng^
ศรีสุวรรณ	s ii s u w a n^
ศรีอาภา	s ii z aa ph aa
ศรีเมือง	s ii m vva ng^
ศรีเรศ	s ii r ee t^
ศรีไพร	s ii phr a j^
ศรีไศล	s ii s a l a j^
ศรุชา	s a r u ch aa
ศรุต	s a r u t^
ศรเพชร	s @@ n^ ph ee t^
ศฤงคาร	s a r v ng^ kh aa n^
ศศลักษณ์	s a s a l a k^
ศศิ	s a s i
ศศิกานต์	s a s i k aa n^
ศศิธร	s a s i th @@ n^
ศศินา	s a s i n aa
ศศิมาภรณ์	s a s i m aa ph @@ n^
ศักดา	s a k^ d aa
ศักดิชัย	s a k^ d i ch a j^
ศักดิ์	s a k^
ศักดิ์ชัย	s a k^ ch a j^
ศักดิ์ชาย	s a k^ ch aa j^
ศักดิ์ณรงค์	s a k^ n a r o ng^
ศักดิ์นิรันดร์	s a k^ n i r a n^
ศักดิ์น้อย	s a k^ n @@ j^
ศักดิ์ระพี	s a k^ r a ph ii
ศักดิ์สมัย	s a k^ s a m a j^
ศักดิ์สมุทร	s a k^ s a m u t^
ศักดิ์สยาม	s a k^ s a j aa m^
ศักดิ์สิทธิ์	s a k^ s i t^
ศักดิ์สิริ	s a k^ s i r i
ศักดิ์เกษม	s a k^ k a s ee m^
ศักราช	s a k^ k a r aa t^
ศันสนีย์	s a n^ s a n ii
ศัลย์	s a n^
ศิขรินธาร	s i kh a r i n^ th aa n^
ศิณะ	s i n a
ศิตา	s i t aa
ศิธา	s i th aa
ศิรชัช	s i r a ch a t^
ศิรประภา	s i r a pr a ph aa
ศิรพันธ์	s i r a ph a n^
ศิรศักดิ์	s i r a s a k^
ศิระ	s i r a
ศิรัฐ	s i r a t^
ศิริ	s i r i
ศิริกาญจน์	s i r i k aa n^
ศิรินทรา	s i r i n^ thr aa
ศิรินทร์	s i r i n^
ศิรินทิพย์	s i r i n^ th i p^
ศิรินภา	s i r i n a ph aa
ศิรินันท์	s i r i n a n^
ศิรินุช	s i r i n u t^
ศิริน้อย	s i r i n @@ j^
ศิริพงษ์	s i r i ph o ng^
ศิริพร	s i r i ph @@ n^
ศิริพล	s i r i ph o n^
ศิริพิชญ์	s i r i ph i t^
ศิริพิชยา	s i r i ph i t^ ch a j aa
ศิริมงคล	s i r i m o ng^ kh o n^
ศิริมาศ	s i r i m aa t^
ศิริลักษณ์	s i r i l a k^
ศิริวร	s i r i w @@ n^
ศิริวรรณ	s i r i w a n^
ศิริวัฒน์	s i r i w a t^
ศิริศักดิ์	s i r i s a k^
ศิริศิลป์	s i r i s i n^
ศิริเทพ	s i r i th ee p^
ศิริโชค	s i r i ch oo k^
ศิริโรจน์	s i r i r oo t^
ศิลป์	s i n^
ศิลป์ชนก	s i n^ ch a n o k^
ศิลา	s i l aa
ศิลาวรรณ	s i l aa w a n^
ศิวกร	s i w a k @@ n^
ศิวกรณ์	s i w a k @@ n^
ศิวรักษ์	s i w a r a k^
ศิวรุต	s i w a r u t^
ศิวัฒน์	s i w a t^
ศิวัส	s i w a t^
ศุ	s u
ศุกร์วัฒนา	s u k^ w a t^ th a n aa
ศุกล	s u k o n^
ศุกลวัฒน์	s u k^ l a w a t^
ศุทธนะ	s u t^ th a n a
ศุภกร	s u p^ ph a k @@ n^
ศุภกรณ์	s u p^ ph a k @@ n^
ศุภกิจ	s u p^ ph a k i t^
ศุภชัย	s u p^ ph a ch a j^
ศุภณัฏฐ์	s u p^ ph a n a t^
ศุภณัฐ	s u p^ ph a n a t^
ศุภนร	s u p^ ph a n @@ n^
ศุภนันท์	s u p^ ph a n a n^
ศุภนาฎ	s u p^ ph a n aa t^
ศุภนิดา	s u p^ ph a n i d aa
ศุภพงษ์	s u p^ ph a ph o ng^
ศุภพรพงศ์	s u p^ ph a ph @@ n^ ph o ng^
ศุภมร	s u p^ ph a m @@ n^
ศุภมาศ	s u p^ ph a m aa t^
ศุภมาส	s u p^ ph a m aa t^
ศุภมิตร	s u p^ ph a m i t^
ศุภรักษ์	s u ph a r a k^
ศุภรัตน์	s u ph a r a t^
ศุภรุจ	s u p^ ph a r u t^
ศุภวัฒน์	s u p^ ph a w a t^
ศุภวิชญ์	s u p^ ph a w i t^
ศุภวุฒิ	s u p^ ph a w u t^
ศุภสิทธิ์	s u p^ ph a s i t^
ศุภสิธ	s u p^ ph a s i t^
ศุภักษร	s u ph a k^ s @@ n^
ศุภัคชญา	s u ph a k^ ch a j aa
ศุภัชญา	s u ph a t^ j aa
ศุภานิช	s u ph aa n i t^
ศุลี	s u l ii
ศุลีพร	s u l ii ph @@ n^
ษรฉัตร	s @@ n^ ch a t^
ษริกา	s a r i k aa
สกนธ์	s a k o n^
สกล	s a k o n^
สกัด	s a k a t^
สกัดเพชร	s a k a t^ ph ee t^
สกาวใจ	s a k aa w^ c a j^
สกุล	s a k u n^
สงกรานต์	s o ng^ kr aa n^
สงคราม	s o ng^ khr aa m^
สงบ	s a ng o p^
สงวน	s a ng uua n^
สงวนศรี	s a ng uua n^ s ii
สงัด	s a ng a t^
สง่า	s a ng aa
สด	s o t^
สดศรี	s o t^ s ii
สดใส	s o t^ s a j^
สตางค์	s a t aa ng^
สถาพร	s a th aa ph @@ n^
สถิตย์	s a th i t^
สนฉัตร	s o n^ ch a t^
สนธยา	s o n^ th a j aa
สนธิ	s o n^ th i
สนธิรัตน์	s o n^ th i r a t^
สนอง	s a n @@ ng^
สนั่น	s a n a n^
สนานจิตต์	s a n aa n^ c i t^
สนิท	s a n i t^
สบชัย	s o p^ ch a j^
สปอนเซอร์	s a p @ n^ s qq
สพรั่ง	s a phr a ng^
สม	s o m^
สมควร	s o m^ kh uua n^
สมคิด	s o m^ kh i t^
สมจิตต์	s o m^ c i t^
สมจิตร	s o m^ c i t^
สมจินต์	s o m^ c i n^
สมชัย	s o m^ ch a j^
สมชาย	s o m^ ch aa j^
สมถวิล	s o m^ th a w i n^
สมทัต	s o m^ m a th a t^
สมนภา	s o m^ n a ph aa
สมนเล๊าะ	s o m^ @
สมบัติ	s o m^ b a t^
สมบุญ	s o m^ b u n^
สมบูรณ์	s o m^ b uu n^
สมประสงค์	s o m^ pr a s o ng^
สมปอง	s o m^ p @@ ng^
สมพงษ์	s o m^ ph o ng^
สมพร	s o m^ ph @@ n^
สมพล	s o m^ ph o n^
สมพัฒน์	s o m^ ph a t^
สมภพ	s o m^ ph o p^
สมมาส	s o m^ m aa t^
สมมุติ	s o m^ m u t^
สมยศ	s o m^ j o t^
สมรถ	s o m^ r o t^
สมรักษ์	s o m^ m a r a k^
สมฤทัย	s o m^ r v th a j^
สมศักดิ์	s o m^ s a k^
สมศักย์	s o m^ s a k^
สมศาสตร์	s o m^ m a s aa t^
สมสุข	s o m^ s u k^
สมหมาย	s o m^ m aa j^
สมหฤทัย	s o m^ h a r v th a j^
สมหวัง	s o m^ w a ng^
สมอ	s a m @@
สมัคร	s a m a k^
สมัชชา	s a m a t^ ch aa
สมัย	s a m a j^
สมาน	s a m aa n^
สมานฉันท์	s a m aa n^ ch a n^
สมาพร	s a m aa ph @@ n^
สมิง	s a m i ng^
สมิงหนุ่ม	s a m i ng^ n u m^
สมิตา	s a m i t aa
สมิทธ	s a m i t^
สมิทธิ์	s a m i t^
สมุทร	s a m u t^
สมุทร์	s a m u t^
สมเกียรติ	s o m^ k iia t^
สมเจต	s o m^ c ee t^
สมเจตน์	s o m^ c ee t^
สมเจตร	s o m^ c ee t^
สมเดช	s o m^ d ee t^
สมเด็จพระกษิฐาธิราชเจ้า	s o m^ d e t^ phr a k a s i th aa th i r aa t^ c aa w^
สมเด็จพระญาณสังวร	s o m^ d e t^ phr a j aa n^ n a s a ng^ w @@ n^
สมเด็จพระนางเจ้ารำไพพรรณี	s o m^ d e t^ phr a n aa ng^ c aa w^ r a m^ ph a j^ ph a n^ n ii
สมเด็จพระนางเจ้าสิริกิติ์	s o m^ d e t^ phr a n aa ng^ c aa w^ s i r i k i t^
สมเด็จพระนางเจ้าสุทิดา	s o m^ d e t^ phr a n aa ng^ c aa w^ s u th i d aa
สมเด็จพระนางเจ้าสุนันทากุมารีรัตน์	s o m^ d e t^ phr a n aa ng^ c aa w^ s u n a n^ th aa k u m aa r ii r a t^
สมเด็จพระนางเจ้าอินทรศักดิศจี	s o m^ d e t^ phr a n aa ng^ c a w^ z i n^ th a r a s a k^ d i t^ c ii
สมเด็จพระบรมราชาธิราชที่	s o m^ d e t^ phr a b @@ r o m^ r aa ch aa th i r aa t^ th ii
สมเด็จพระบรมโอรสาธิราช	s o m^ d e t^ phr a b @@ r o m^ z oo r a s aa th i r aa t^
สมเด็จพระปิตุจฉาเจ้าสุขุมาลมารศรี	s o m^ d e t^ phr a p i t u t^ ch aa c a w^ s u kh u m aa n^ m aa r a s ii
สมเด็จพระปิยมาวดี	s o m^ d e t^ phr a p i j a m aa w a d ii
สมเด็จพระมหาสมณเจ้า	s o m^ d e t^ phr a m a h aa s a m a n a c aa w^
สมเด็จพระมหิตลาธิเบศร	s o m^ d e t^ phr a m a h i t^ t a l aa th i b ee t^
สมเด็จพระราชปิตุจฉา	s o m^ d e t^ phr a r aa t^ ch a p i t u t^ ch aa
สมเด็จพระราชปิตุลาบรมพงศาภิมุข	s o m^ d e t^ phr a r aa t^ ch a p i t u l aa b @@ z^0 r o m^ ph o ng^ s aa ph i m u k^
สมเด็จพระรามาธิบดีที่	s o m^ d e t^ phr a r aa m aa th i p^ b @@ d ii th ii
สมเด็จพระศรีพัชรินทราบรมราชินีนาถ	s o m^ d e t^ phr a s ii ph a t^ ch a r i n^ thr aa b @@ r o m^ r aa ch i n ii n aa t^
สมเด็จพระศรีสวรินทิราบรมราชเทวี	s o m^ d e t^ phr a s ii s a w a r i n^ th i r aa b @@ r o m^ r aa t^ th ee w ii
สมเด็จพระสรรเพชญ์ที่	s o m^ d e t^ phr a s a n^ ph ee t^ th ii
สมเด็จพระอนุชาธิราช	s o m^ d e t^ phr a z a n u ch aa th i r aa t^
สมเด็จพระอริยวงศาคตญาณ	s o m^ d e t^ phr a z a r i j a w o ng^ s aa kh o t^ t a j aa n^
สมเด็จพระเจ้าน้องนางเธอ	s o m^ d e t^ phr a c aa w^ n @@ ng^ n aa ng^ th qq
สมเด็จพระเจ้าบรมวงศ์เธอ	s o m^ d e t^ phr a c aa w^ b @@ r o m^ m a w o ng^ th qq
สมเด็จพระเจ้าภคินีเธอ	s o m^ d e t^ phr a c a w^ ph a kh i n ii th qq
สมเด็จพระเจ้าลูกยาเธอ	s o m^ d e t^ phr a c aa w^ l uu k^ j aa th qq
สมเด็จพระเจ้าลูกเธอ	s o m^ d e t^ phr a c aa w^ l uu k^ th qq
สมเด็จพระเจ้าหลานเธอ	s o m^ d e t^ phr a c a w^ l aa n^ th qq
สมเถา	s o m^ th a w^
สมเพียร	s o m^ ph iia n^
สมโพธิ	s o m^ ph oo
สมโภช	s o m^ ph oo t^
สมโภชน์	s o m^ ph oo t^
สมใจ	s o m^ c a j^
สยมภู	s a j o m^ ph uu
สยุมภู	s a j u m^ ph uu
สรจักร	s @@ r a c a k^
สรชาติ	s @@ r a ch aa t^
สรพงศ์	s @@ r a ph o ng^
สรยุทธ	s @@ r a j u t^
สรรค์ชัย	s a n^ ch a j^
สรรพภัญญู	s a p^ ph a ph a n^ j uu
สรรัศมิ์	s @@ r a r a t^
สรรเสริญ	s a n^ s qq n^
สรวงศ์	s @@ r a w o ng^
สรวงสุดา	s uua ng^ s u d aa
สรวิชญ์	s @@ r a w i t^
สรวิทย์	s @@ r a w i t^
สรศักดิ์	s @@ r a s a k^
สรอรรถ	s @@ r a z a t^
สรัณณัฏฐ์	s a r a n^ n a t^
สรัลชนา	s a n^ ch a n aa
สรัลธร	s a n^ th @@ n^
สราญจิตต์	s a r aa n^ c i t^
สรานนท์	s a r aa n o n^
สรานี	s a r aa n ii
สรารัตน์	s a r aa r a t^
สราลีย์	s a r aa l ii
สราวุฒิ	s a r aa w u t^
สราวุธ	s a r aa w u t^
สริตา	s i t aa
สรเพชร	s @@ n^ ph ee t^
สร้อยสน	s @ j^ s o n^
สฤต	s a r i t^
สฤษดิ์	s a r i t^
สลักจิต	s a l a k^ c i t^
สลา	s a l aa
สลิลทิพย์	s a l i n^ th i p^
สล้าง	s a l aa ng^
สวง	s uua ng^
สวนิต	s a w a n i t^
สวรรยา	s a w a n^ j aa
สวลี	s a w a l ii
สวัสดิ์	s a w a t^
สวาสดิ์	s a w aa t^
สวิช	s a w i t^
สวิชญา	s a w i t^ ch a j aa
สศิรา	s @@ s i r aa
สสิน	s a s i n^
สหรัฐ	s a h a r a t^
สหรัฐต์	s a h a r a t^
สหรัถ	s a h a r a t^
สหรัส	s a h a r a t^
สหวิช	s a h a w i t^
สหสมภพ	s a h a s o m^ ph o p^
สหัส	s a h a t^
สหัสวรรษ	s a h a t^ s a w a t^
สอ	s @@
สองณรงค์	s @@ ng^ n a r o ng^
สอน	s @@ n^
สอาด	s a z aa t^
สะสม	s a s o m^
สะเบต	s a b ee t^
สะแกวัลย์	s a k xx w a n^
สัก	s a k^
สักกทัศน์	s a k^ k a th a t^
สักก์ดนัย	s a k^ d a n a j^
สังข์	s a ng^
สังข์ทอง	s a ng^ th @@ ng^
สัจจากาจ	s a t^ c aa k aa t^
สัญชัย	s a n^ ch a j^
สัญญา	s a n^ j aa
สัณฐาน	s a n^ th aa n^
สัตบุตร	s a t^ t a b u t^
สันติ	s a n^ t i
สันติสุข	s a n^ t i s u k^
สันติ์	s a n^
สันต์ศักด์	s a n^ s a k^
สันทินี	s a n^ th i n ii
สัพพัญญู	s a p^ ph a n^ j uu
สัมพันธ์	s a m^ ph a n^
สากล	s aa k o n^
สาคร	s aa kh @@ n^
สาครินทร์	s aa kh a r i n^
สาทิตย์	s aa th i t^
สาทิส	s aa th i t^
สาธิกา	s aa th i k aa
สาธิดา	s aa th i d aa
สาธิต	s aa th i t^
สาธินี	s aa th i n ii
สามารถ	s aa m aa t^
สามารถเล็ก	s aa m aa t^ l e k^
สามเอ	s aa m^ z ee
สายชล	s aa j^ ch o n^
สายทิพย์	s aa j^ th i p^
สายธาร	s aa j^ th aa n^
สายพิณ	s aa j^ ph i n^
สายฟ้า	s aa j^ f aa
สายรุ้ง	s aa j^ r u ng^
สายลม	s aa j^ l o m^
สายลับ	s aa j^ l a p^
สายสวรรค์	s aa j^ s a w a n^
สายสี่เล็ก	s aa j^ s ii l e k^
สายสุนีย์	s aa j^ s u n ii
สายสุรี	s aa j^ s u r ii
สายหยุด	s aa j^ j u t^
สายัณห์	s aa j a n^
สายเชีย	s aa j^ ch iia
สายเพชร	s aa j^ ph ee t^
สายไหม	s aa j^ m a j^
สารัช	s aa r a t^
สาริกา	s aa r i k aa
สาริกาเล็ก	s aa r i k aa l e k^
สาริน	s aa r i n^
สาวมาด	s aa w^ m aa t^
สาวิกา	s aa w i k aa
สาวิณี	s aa w i n ii
สาวิตต์	s aa w i
สาวิตรี	s aa w i tr ii
สาวิทย์	s aa w i t^
สาโรจน์	s aa r oo t^
สำราญ	s a m^ r aa n^
สำราญทอง	s a m^ r aa n^ th @@ ng^
สำราญศักดิ์	s a m^ r aa n^ s a k^
สำเนียง	s a m^ n iia ng^
สำเภา	s a m^ ph a w^
สิงหา	s i ng^ h aa
สิงห์ดำ	s i ng^ d a m^
สิงห์ทอง	s i ng^ th @@ ng^
สิงห์น้อย	s i ng^ n @@ j^
สิงห์ประเสริฐ	s i ng^ pr a s qq t^
สิงห์มณี	s i ng^ m a n ii
สิงห์ศึก	s i ng^ s v k^
สิงห์สมุทร	s i ng^ s a m u t^
สิงห์สยาม	s i ng^ s a j aa m^
สิงห์หนุ่ม	s i ng^ n u m^
สิงโต	s i ng^ t oo
สิดดิก	s i t^ d i k^
สิตางศุ์	s i t aa ng^ s
สิทธา	s i t^ th aa
สิทธิ	s i t^ th i
สิทธิคมน์	s i t^ th i kh o m^
สิทธิชัย	s i t^ th i ch a j^
สิทธิพงษ์	s i t^ th i ph o ng^
สิทธิพร	s i t^ th i ph @@ n^
สิทธิพันธ์	s i t^ th i ph a n^
สิทธิวัฒน์	s i t^ th i w a t^
สิทธิศักดิ์	s i t^ th i s a k^
สิทธิโชค	s i t^ th i ch oo k^
สินจัย	s i n^ c a j^
สินทรัพย์	s i n^ s a p^
สินทวีชัย	s i n^ th a w ii ch a j^
สินธพ	s i n^ th o p^
สินธุ์เพชร	s i n^ ph ee t^
สินี	s i n ii
สินีนาฏ	s i n ii n aa t^
สิปปนนท์	s i p^ p a n o n^
สิรคุปต์	s i r a kh u p^
สิริ	s i r i
สิรินทร	s i r i n^ th @@ n^
สิรินทร์	s i r i n^
สิริมา	s i r i m aa
สิริยากร	s i r i j aa k @@ n^
สิริรัตน์	s i r i r a t^
สิริลภัค	s i r i n^ ph a k^
สิริลภัส	s i r i n^ ph a t^
สิริเนตร	s i r i n ee t^
สิรีธร	s i r ii th @@ n^
สิรีภรณ์	s i r ii ph @@ n^
สิลา	s i l aa
สิวะ	s i w a
สิเรียม	s i r iia m^
สิโรจน์	s i r oo t^
สีหนุ่ม	s ii n u m^
สีเทา	s ii th a w^
สีเผือก	s ii ph vva k^
สี่มนุษย์	s ii m a n u t^
สืบ	s vv p^
สืบศักดิ์	s vv p^ s a k^
สืบสวัสดิ์	s vv p^ s a w a t^
สุ	s u
สุกรี	s u kr ii
สุกฤษฎิ์	s u kr i t^
สุกัญญา	s u k a n^ j aa
สุกำพล	s u k a m^ ph o n^
สุกิจ	s u k i t^
สุกุมล	s u k u m o n^
สุข	s u k^
สุขวิช	s u k^ kh a w i t^
สุขวิชชาญ	s u k^ kh a w i t^ ch aa n^
สุขสวัสดิ์	s u k^ s a w a t^
สุขสันต์	s u k^ s a n^
สุขุม	s u kh u m^
สุขุมพงศ์	s u kh u m^ ph o ng^
สุคนธวา	s u kh o n^ th a w aa
สุคนธ์	s u kh o n^
สุคนธ์ทิพย์	s u kh o n^ th i p^
สุจาริณี	s u c aa r i n ii
สุจิตต์	s u c i t^
สุจิตรา	s u c i t^ tr aa
สุจินดา	s u c i n^ d aa
สุจินต์	s u c i n^
สุจิรา	s u c i r aa
สุชญา	s u t^ ch a j aa
สุชน	s u ch o n^
สุชัชวีร์	s u ch a t^ ch a w ii
สุชัย	s u ch a j^
สุชาดา	s u ch aa d aa
สุชาติ	s u ch aa t^
สุชานัน	s u ch a n a n^
สุชาย	s u ch aa j^
สุชาร์	s u ch aa
สุชิน	s u ch i n^
สุชีน	s u ch ii n^
สุชีพ	s u ch ii p^
สุฐิตา	s u t^ th i t aa
สุณิสา	s u n i s aa
สุณีย์	s u n ii
สุด	s u t^
สุดจิตต์	s u t^ c i t^
สุดสาคร	s u t^ s aa kh @@ n^
สุดา	s u d aa
สุดารัตน์	s u d aa r a t^
สุดิน	s u d i n^
สุดเขต	s u t^ kh ee t^
สุตสาย	s u t a s aa j^
สุทธาทิพย์	s u t^ th aa th i p^
สุทธิ	s u t^ th i
สุทธิชัย	s u t^ th i ch a j^
สุทธิณัฐ	s u t^ th i n a t^
สุทธิดา	s u t^ th i d aa
สุทธินันท์	s u t^ th i n a n^
สุทธิพงศ์	s u t^ th i ph o ng^
สุทธิพงษ์	s u t^ th i ph o ng^
สุทธิพันธ์	s u t^ th i ph a n^
สุทธิภา	s u t^ th i ph aa
สุทธิลักษณ์	s u t^ th i l a k^
สุทธิศักดิ์	s u t^ th i s a k^
สุทัตตา	s u th a t^ t aa
สุทัศน์	s u th a t^
สุทิน	s u th i n^
สุทิวัส	s u th i w a t^
สุทิศา	s u th i s aa
สุธรรม	s u th a m^
สุธา	s u th aa
สุธาชัย	s u th aa ch a j^
สุธาวัลย์	s u th aa w a n^
สุธาสินี	s u th aa s i n ii
สุธิดา	s u th i d aa
สุธิตา	s u th i t aa
สุธิยา	s u th i j aa
สุธิราช	s u th i r aa t^
สุธี	s u th ii
สุธีวัน	s u th ii w a n^
สุนทร	s u n^ th @@ n^
สุนทรี	s u n^ thr ii
สุนทรียา	s u n^ th a r ii j aa
สุนันทา	s u n a n^ th aa
สุนันท์ษา	s u n a n^ s aa
สุนัย	s u n a j^
สุนารี	s u n aa r ii
สุนิตา	s u n i t aa
สุนิสา	s u n i s aa
สุนีย์	s u n ii
สุบรรณ	s u b a n^
สุบิน	s u b i n^
สุประวัติ	s u pr a w a t^
สุประวีณ์	s u pr a w ii n^
สุพจน์	s u ph o t^
สุพร	s u ph @@ n^
สุพรรณ	s u ph a n^
สุพรรษา	s u ph a n^ s aa
สุพล	s u ph o n^
สุพัฒน์	s u ph a t^
สุพัตรา	s u ph a t^ tr aa
สุพันธุ์	s u ph a n^
สุพีร์พัฒน์	s u ph ii ph a t^
สุภรณ์	s u ph @@ n^
สุภัค	s u ph a k^
สุภัชชา	s u ph a t^ ch aa
สุภัสสรา	s u ph a t^ s a r aa
สุภา	s u ph aa
สุภาพ	s u ph aa p^
สุภาพร	s u ph aa ph @@ n^
สุภาภรณ์	s u ph aa ph @@ n^
สุภาว์	s u ph aa
สุภิญญา	s u ph i n^ j aa
สุภีร์	s u ph ii
สุภโชค	s u p^ ph a ch oo k^
สุมณทิพย์	s u m o n^ th i p^
สุมล	s u m o n^
สุมัญญา	s u m a n^ j aa
สุรจิตร	s u r a c i t^
สุรชัย	s u r a ch a j^
สุรชาติ	s u r a ch aa t^
สุรทิน	s u r a th i n^
สุรนันทน์	s u r a n a n^
สุรบถ	s u r a b o t^
สุรพงษ์	s u r a ph o ng^
สุรพร	s u r a ph @@ n^
สุรพรชัย	s u r a ph @@ n^ ch a j^
สุรพล	s u r a ph o n^
สุรพันธ์	s u r a ph a n^
สุรยงค์	s u r a j o ng^
สุรยุทธ์	s u r a j u t^
สุรวัช	s u r a w a t^
สุรวิทย์	s u r a w i t^
สุรวุฑ	s u r a w u t^
สุรศักดิ์	s u r a s a k^
สุรสาล	s u r a s aa n^
สุรสิทธิ์	s u r a s i t^
สุรสีห์	s u r a s ii
สุรัฐ	s u r a t^
สุรัตนาวี	s u r a t^ t a n aa w ii
สุรัตน์	s u r a t^
สุรัตน์ติกานต์	s u r a t^ t i k aa n^
สุรัสวดี	s u r a t^ s a w a d ii
สุรางค์	s u r aa ng^
สุรินทร์	s u r i n^
สุริยนต์	s u r i j o n^
สุริยะ	s u r i j a
สุริยะใส	s u r i j a s a j^
สุริยัน	s u r i j a n^
สุริยา	s u r i j aa
สุริวิภา	s u r i w i ph aa
สุรีย์	s u r ii
สุรเกียรติ	s u r a k iia t^
สุรเกียรติ์	s u r a k iia t^
สุรเชษฐ์	s u r a ch ee t^
สุรเดช	s u r a d ee t^
สุรเทิน	s u r a th qq n^
สุรใจ	s u r a j^ c a j^
สุลต่าน	s u n^ l a t aa n^
สุลักษณ์	s u l a k^
สุลาลีวัลย์	s u l aa l ii w a n^
สุวดี	s u w a d ii
สุวนันท์	s u w a n a n^
สุวบุญ	s u w a b u n^
สุวพิชญ์	s u w a ph i t^
สุวรรณ	s u w a n^
สุวรรณภัทร	s u w a n^ n a ph a t^
สุวรรณี	s u w a n^ n ii
สุวัจชัย	s u w a t^ ch a j^
สุวัจนี	s u w a t^ n ii
สุวัจน์	s u w a t^
สุวัฒน์	s u w a t^
สุวิกรม	s u w i kr o m^
สุวิชช	s u w i ch o t^
สุวิชา	s u w i ch aa
สุวิทย์	s u w i t^
สุวีระ	s u w ii r a
สุวโรช	s u w a r oo t^
สุษิรา	s u s i r aa
สุเจตน์	s u c ee t^
สุเชาว์	s u ch a w^
สุเทพ	s u th ee p^
สุเบญรัตน์	s u b ee n^ r a t^
สุเมธ	s u m ee t^
สุโข	s u kh oo
สู่ขวัญ	s uu khw a n^
สเกน	s a k ee n^
สเตฟานี	s a t ee f aa n ii
สเลมาลย์	s a l ee m aa n^
สโรชา	s a r oo ch aa
ส่ง	s o ng^
ส่งสุข	s o ng^ s u k^
ส้มเช้ง	s o m^ ch ee ng^
หงษ์ทอง	h o ng^ th @@ ng^
หงหยก	h o ng^ j o k^
หญิง	j i ng^
หญิงลี	j i ng^ l ii
หทัยชัช	h a th a j^ ch a t^
หทัยภัทร	h a th a j^ ph a t^
หทัยรัตน์	h a th a j^ r a t^
หทัยวรรณ	h a th a j^ w a n^
หนองคาย	n @@ ng^ kh aa j^
หนึ่งธิดา	n v ng^ th i d aa
หนึ่งนัดดา	n v ng^ n a t^ d aa
หนึ่งฤทัย	n v ng a r v th a j^
หนึ่งอุบล	n v ng^ z u b o n^
หนึ่งเดียว	n v ng^ d iia w^
หนุมาน	h a n u m aa n^
หนู	n uu
หนูฮัก	n uu h a k^
หม่อมกมลา	m @@ m^ k a m^ m a l aa
หม่อมงามจิตต์	m @ m^ ng aa m^ c i t^
หม่อมดุษฎี	m @@ m^ d u t^ s a d ii
หม่อมทิพวัน	m @ m^ th i p^ w a n^
หม่อมบัวเขียว	m @ m^ b uua kh iia w^
หม่อมราชวงศ์จักรทอง	m @ m^ r aa t^ ch a w o ng^ c a k^ th @@ ng^
หม่อมราชวงศ์จัตุมงคล	m @ m^ r aa t^ ch a w o ng^ c a t^ t u m o ng^ kh o n^
หม่อมราชวงศ์ดำรงดิศ	m @ m^ r aa t^ ch a w o ng^ d a m^ r o ng^ d i t^
หม่อมราชวงศ์ถนัดศรี	m @ m^ r aa t^ ch a w o ng^ th a n a t^ s ii
หม่อมราชวงศ์นริศรา	m @ m^ r aa t^ ch a w o ng^ n a r i t^ s a r aa
หม่อมราชวงศ์บุษบา	m @ m^ r aa t^ ch a w o ng^ b u t^ s a b aa
หม่อมราชวงศ์ปรีดิยาธร	m @ m^ r aa t^ ch a w o ng^ pr ii d i j aa th @@ n^
หม่อมราชวงศ์พงษ์สวัสดิ์	m @ m^ r aa t^ ch a w o ng^ ph o ng^ s a w a t^
หม่อมราชวงศ์มงคลชาย	m @ m^ r aa t^ ch a w o ng^ m o ng^ kh o n^ ch aa j^
หม่อมราชวงศ์มิตรารุณ	m @ m^ r aa t^ ch a w o ng^ m i t^ tr aa r u n^
หม่อมราชวงศ์ศุภวัฒย์	m @ m^ r aa t^ ch a w o ng^ s u p^ ph a w a t^ th a j^
หม่อมราชวงศ์สังขดิศ	m @ m^ r aa t^ ch a w o ng^ s a ng^ d i t^
หม่อมราชวงศ์สุขุมพันธุ์	m @ m^ r aa t^ ch a w o ng^ s u kh u m^ ph a n^
หม่อมราชวงศ์เกษมสโมสร	m @ m^ r aa t^ ch a w o ng^ k a s ee m^ s a m oo s @@ n^
หม่อมราชวงศ์เฉลิมชาตรี	m @ m^ r aa t^ ch a w o ng^ ch a l qq m^ ch aa tr ii
หม่อมราชวงศ์เทพ	m @ m^ r aa t^ ch a w o ng^ th ee p^
หม่อมราชวงศ์แม้นนฤมาส	m @ m^ r aa t^ ch a w o ng^ m xx n^ n a r v m aa t^
หม่อมศรีนวล	m @@ m^ s ii n uua n^
หม่อมหลวงขาบ	m @@ m^ l uua ng^ kh aa p^
หม่อมหลวงจรัญ	m @@ m^ l uua ng^ c a r a n^
หม่อมหลวงชูชาติ	m @@ m^ l uua ng^ ch uu ch aa t^
หม่อมหลวงต้อย	m @@ m^ l uua ng^ t @ j^
หม่อมหลวงบุญเหลือ	m @@ m^ l uua ng^ b u n^ l vva
หม่อมหลวงปนัดดา	m @@ m^ l uua ng^ p a n a t^ d aa
หม่อมหลวงปิยาภัสร์	m @@ m^ l uua ng^ p i j aa ph a t^
หม่อมหลวงปิ่น	m @@ m^ l uua ng^ p i n^
หม่อมหลวงพวงร้อย	m @@ m^ l uua ng^ ph uua ng^ r @@ j^
หม่อมหลวงมานิจ	m @@ m^ l uua ng^ m aa n i t^
หม่อมหลวงมิ่งมงคล	m @@ m^ l uua ng^ m i ng^ m o ng^ kh o n^
หม่อมหลวงยิ่งศักดิ์	m @@ m^ l uua ng^ j i ng^ s a k^
หม่อมหลวงศรีฟ้า	m @@ m^ l uua ng^ s ii f aa
หม่อมหลวงศิริเฉลิม	m @@ m^ l uua ng^ s i r i ch a l qq m^
หม่อมหลวงสราลี	m @@ m^ l uua ng^ s o aa l ii
หม่อมหลวงสุรีย์วัล	m @@ m^ l uua ng^ s u r ii w a n^
หม่อมหลวงอภิมงคล	m @@ m^ l uua ng^ z a ph i m o ng^ kh o n^
หม่อมหลวงอัศนี	m @@ m^ l uua ng^ z a t^ s a n ii
หม่อมหลวงอุดม	m @@ m^ l uua ng^ z u d o m^
หม่อมหลวงเชิงชาญ	m @@ m^ l uua ng^ ch qq ng^ ch aa n^
หม่อมหลวงเดช	m @@ m^ l uua ng^ d ee t^
หม่อมเจียงคำ	m @@ m^ c iia ng^ kh a m^
หม่อมเจ้ากรณิกา	m @@ m^ c a w^ k @@ n^ n i k aa
หม่อมเจ้าชาตรีเฉลิม	m @@ m^ c a w^ ch aa tr ii ch ee l i m^
หม่อมเจ้าฑิฆัมพร	m @@ m^ c aa w^ th i kh a m^ ph @@ n^
หม่อมเจ้าทองคำเปลว	m @@ m^ c a w^ th @@ ng^ kh a m^ pl ee w^
หม่อมเจ้าทองเติม	m @@ m^ c a w^ th @@ ng^ t qq m^
หม่อมเจ้าธงชัยสิริพันธ์	m @@ m^ c aa w^ th o ng^ ch a j^ s i r i ph a n^
หม่อมเจ้านนทิยาวัด	m @@ m^ c aa w^ n o n^ th i j aa w a t^
หม่อมเจ้านวพรรษ์	m @@ m^ c aa w^ n a w a ph a n^
หม่อมเจ้านิตยากร	m @@ m^ c aa w^ n i t^ th a j aa k @@ n^
หม่อมเจ้าปรีดิเทพย์พงษ์	m @@ m^ c a w^ pr ii th ee p^ ph o ng^
หม่อมเจ้าพรพิมลพรรณ	m @@ m^ c a w^ ph @@ n^ ph i m o n^ ph a n^
หม่อมเจ้าภีศเดช	m @@ m^ c a w^ ph ii s a d ee t^
หม่อมเจ้ามารศีสุขุมพันธุ์	m @@ m^ c a w^ m aa n^ s ii s u kh u m^ ph a n^
หม่อมเจ้ารังษิยากร	m @@ m^ c aa w^ r a ng^ s i j aa k @@ n^
หม่อมเจ้าสิทธิพร	m @@ m^ c a w^ s i t^ th i ph @@ n^
หม่อมเจ้าสุภัทรดิศ	m @@ m^ c a w^ s u ph a t^ th a r a d i t^
หม่อมเจ้าอิทธิเทพสรรค์	m @@ m^ c a w^ z i t^ th i th ee p^ s a n^
หม่อมเจ้าเฉลิมศรีสวัสดิวัตน์	m @@ m^ c a w^ ch a l qq m^ s ii s a w a t^ d i w a t^
หม่อมเจ้าเสรฐศิริ	m @@ m^ c aa w^ s th a s i r i
หม่อมเจ้าไขแสงรพี	m @@ m^ c aa w^ kh a s xx ng^ r a ph ii
หม่อมไฉไล	m @@ m^ ch a j^ l a j^
หม่ำ	m a m^
หยกไท	j o k^ th a j^
หยัด	j a t^
หยาด	j aa t^
หยาดทิพย์	j aa t^ th i p^
หยุด	j u t^
หรรษา	h a n^ s aa
หรินทร์	h a r i n^
หฤทัย	h a r v th a j^
หฤษฎ์	h a r i t^
หฤษฏ์	h a r i t^
หฤหรรษ์	h a r v h a n^
หลวงปู่กงมา	l uua ng^ p uu k o ng^ m aa
หลวงปู่กาหลง	l uua ng^ p uu k aa l o ng^
หลวงปู่ขาว	l uua ng^ p uu kh aa w^
หลวงปู่จันทา	l uua ng^ p uu c a n^ th aa
หลวงปู่ดู่	l uua ng^ p uu d uu
หลวงปู่ตื้อ	l uua ng^ p uu t vv
หลวงปู่บัว	l uua ng^ p uu b uua
หลวงปู่บุญมี	l uua ng^ p uu b u n^ m ii
หลวงปู่ฝั้น	l uua ng^ p uu f a n^
หลวงปู่พรหม	l uua ng^ p uu phr o m^
หลวงปู่มี	l uua ng^ p uu m ii
หลวงปู่ยิ้ม	l uua ng^ p uu j i m^
หลวงปู่รอด	l uua ng^ p uu r @@ t^
หลวงปู่สี	l uua ng^ p uu s ii
หลวงปู่เจือ	l uua ng^ p uu c vva
หลวงปู่แหวน	l uua ng^ p uu w xx n^
หลวงปู่ไข่	l uua ng^ p uu kh a j^
หลวงพ่อกลั่น	l uua ng^ ph @@ kl a n^
หลวงพ่อคง	l uua ng^ ph @@ kh o ng^
หลวงพ่อจง	l uua ng^ ph @@ c o ng^
หลวงพ่อบ่าย	l uua ng^ ph @@ b aa j^
หลวงพ่อผาง	l uua ng^ ph @@ ph aa ng^
หลวงพ่อพรหม	l uua ng^ ph @@ phr o m^
หลวงพ่อฟู	l uua ng^ ph @@ f uu
หลวงพ่อสงฆ์	l uua ng^ ph @@ s o ng^
หลวงพ่อเกษม	l uua ng^ ph @@ k a s ee m^
หลวงพ่อแช่ม	l uua ng^ ph @@ ch xx m^
หลวงพ่อโหน่ง	l uua ng^ ph @@ n oo ng^
หลวงพ่อไปล่	l uua ng^ ph @@ pl a j^
หลักหิน	l a k^ h i n^
หลุยส์	l u j^
หวน	h uua n^
หวัง	w a ng^
หอมหวล	h @@ m^ h uua n^
หะริน	h a r i n^
หัตฐพร	h a t^ th a ph @@ n^
หัตถยา	h a t^ th a j aa
หัสชัย	h a t^ ch a j^
หาญ	h aa n^
หาญฤชัย	h aa n^ r v ch a j^
ห้างทอง	h aa ng^ th @@ ng^
ห้าดาว	h aa d aa w^
อกนิษฐ์	z a k^ k a n i t^
อครา	z a k^ kh a r aa
อคัมย์สิริ	z a kh a m^ s i r i
องค์บาก	z o ng^ b aa k^
องอาจ	z o ng^ z aa t^
อจิรภา	z a c i r a ph aa
อชิตะ	z a ch i t a
อชิรวิชย์	z a ch i r a w i t^
อดิศร	z a d i s @@ n^
อดิศักดิ์	z a d i s a k^
อดิศัย	z a d i s a j^
อดิสรณ์	z a d i s @@ n^
อดิเรก	z a d i r ee k^
อดุล	z a d u n^
อดุลยเดช	z a d u n^ j a d ee t^
อดุลย์	z a d u n^
อดุลรัตน์	z a d u n^ r a t^
อติมา	z a t i m aa
อติรุจ	z a t i r u t^
อทิตยา	z a th i t^ t a j aa
อธิชนัน	z a th i t^ ch a n a n^
อธิป	z a th i p^
อธิปพัฒน์	z a th i p^ p a ph a t^
อธิรัฐ	z a th i r a t^
อธิวัฒน์	z a th i w a t^
อธิษว์	z a th i t^ oo
อนงค์	z a n o ng^
อนงค์พร	z a n o ng^ ph @@ n^
อนงค์วรรณ	z a n o ng^ w a n^
อนัญญา	z a n a n^ j aa
อนัน	z a n a n^
อนันดา	z a n a n^ d aa
อนันตเดช	z a n a n^ t a d ee t^
อนันต์	z a n a n^
อนาวิน	z a n aa w i n^
อนินทิตา	z a n i n^ th i t aa
อนิพรณ์	z a n i ph @@ n^
อนิรุทธ์	z a n i r u t^
อนิส	z a n i t^
อนิสา	z a n i s aa
อนุชศรา	z a n u ch a s a r aa
อนุชา	z a n u ch aa
อนุชิต	z a n u ch i t^
อนุดิษฐ์	z a n u d i t^
อนุตตมา	z a n u t^ t a m aa
อนุทิน	z a n u th i n^
อนุธิดา	z a n u th i d aa
อนุพงษ์	z a n u ph o ng^
อนุภาพ	z a n u ph aa p^
อนุภาษ	z a n u ph aa t^
อนุมัติ	z a n u m a t^
อนุรักษ์	z a n u r a k^
อนุวรรตน์	z a n u w a t^
อนุวัฒน์	z a n u w a t^
อนุวัติ	z a n u w a t^
อนุศักดิ์	z a n u s a k^
อนุศาสน์	z a n u s aa t^
อนุสรณ์	z a n u s @@ n^
อนุสรา	z a n u t^ s a r aa
อบ	z o p^
อบเชย	z o p^ ch qq j^
อพชินี	z o p^ ph a ch i n ii
อภัย	z a ph a j^
อภัสนันท์	z a ph a t^ n a n^
อภิชญา	z a ph i ch a j aa
อภิชัย	z a ph i ch a j^
อภิชาต	z a ph i ch aa t^
อภิชาติ	z a ph i ch aa t^
อภิชาติพงศ์	z a ph i ch aa t^ ph o ng^
อภิญญา	z a ph i n^ j aa
อภินันท์	z a ph i n a n^
อภิภู	z a ph i ph uu
อภิรดี	z a ph i r a d ii
อภิรักษ์	z a ph i r a k^
อภิรัต	z a ph i r a t^
อภิวัชร์	z a ph i w a t^
อภิวัฒน์	z a ph i w a t^
อภิวันท์	z a ph i w a n^
อภิษฎา	z a ph i t^ s a d aa
อภิสมัย	z a ph i t^ s a m a j^
อภิสร	z a ph i s @@ n^
อภิสิทธิ์	z a ph i s i t^
อภิเชษฐ์	z a ph i ch ee t^
อภิเดช	z a ph i d ee t^
อมร	z a m @@ n^
อมรรัตน์	z a m @@ n^ r a t^
อมรา	z a m a r aa
อมราภรณ์	z a m a r aa ph @@ n^
อมรเทพ	z a m @@ n^ th ee p^
อมีนา	z a m ii n aa
อมเรศ	z a m^ m a r ee t^
อยุธยา	z a j u t^ th a j aa
อร	z @@ n^
อรการ	z @@ r a k aa n^
อรจิรา	z @@ n^ c i r aa
อรชุน	z @@ r a ch u n^
อรชุมา	z @@ n^ ch u m aa
อรณิชา	z @@ r a n i ch aa
อรทัย	z @@ r a th a j^
อรนภา	z @@ n^ n a ph aa
อรนุช	z @@ r a n u t^
อรพรรณ	z @@ n^ ph a n^
อรพินท์	z @@ r a ph i n^
อรรคนิธิ์	z a k^
อรรคพล	z a k^ kh a ph o n^
อรรคพันธ์	z a k^ kh a ph a n^
อรรณพ	z a n^ n o p^
อรรถ	z a t^
อรรถกิจ	z a t^ th a k i t^
อรรถชัย	z a t^ th a ch a j^
อรรถพงศ์	z a t^ th a ph o ng^
อรรถพร	z a t^ th a ph @@ n^
อรรถพล	z a t^ th a ph o n^
อรรถพันธ์	z a t^ th a ph a n^
อรรถวดี	z a t^ th a w a d ii
อรรถสิทธิ์	z a t^ th a s i t^
อรลีฬห์	z @@ n^ l ii n^
อรวรรณ	z @@ r a w a n^
อรวิภา	z @@ n^ w i ph aa
อรวิสา	z @@ r a w i s aa
อรวี	z @@ r a w ii
อรสม	z @@ r a s o m^
อรสา	z @@ r a s aa
อรอนงค์	z @@ n^ z a n o ng^
อรอุมา	z @@ n^ z u m aa
อรัชมน	z a r a t^ ch a m o n^
อรัญญา	z a r a n^ j aa
อริชัย	z a r i ch a j^
อริญากร	z a r i j aa k @@ n^
อริต์ตา	z a r i t aa
อริยา	z a r i j aa
อริย์กันตา	z @@ n^ k a n^ t aa
อริศรา	z a r i t^ s a r aa
อริษรา	z a r i t^ s a r aa
อริสมันต์	z a r i s^ m a n^
อริสรา	z a r i t^ s a r aa
อรุชา	z a r u ch aa
อรุณ	z a r u n^
อรุณณภา	z a r u n^ n a ph aa
อรุณพงศ์	z a r u n^ ph o ng^
อรุณลักษณ์	z a r u n^ n a l a k^
อรุณี	z a r u n ii
อรุโณทัย	z a r u n oo th a j^
อรเณศ	z @@ r a n ee t^
อร่ามอาชว์วัต	z a r aa m^ z aa ch oo w a t^
อลงกต	z a l o ng^ k o t^
อลงกรณ์	z a l o ng^ k @@ n^
อลิชา	z a l i ch aa
อลิศ	z a l i t^
อลิศรา	z a l i t^ s a r aa
อลิษา	z a l i s aa
อลิสา	z a l i s aa
อลีสญาฌ์	z a l ii t^ j aa ch
อวยชัย	z uua j^ ch a j^
ออกัสต์	z @@ k a t^
ออมทรัพย์	z @@ m^ s a p^
ออย	z @@ j^
ออสการ์	z @@ t^ k aa
ออสุต	z @ t^ s u t^
อะมีณยา	z a m ii n^ j aa
อะแมนดา	z a m xx n^ d aa
อักขราทร	z a k^ kh a r aa th @@ n^
อัครพล	z a k^ kh a r a ph o n^
อัครวินทร์	z a k^ kh a r a w i n^
อัครัฐ	z a k^ kh a r a t^
อัครินทร์	z a k^ kh a r i n^
อังคณา	z a ng^ kh a n aa
อังคนางค์	z a ng^ kh a n aa ng^
อังคาร	z a ng^ kh aa n^
อังศุมาลิน	z a ng^ s u m aa l i n^
อัจจิมา	z a t^ c i m aa
อัจฉรา	z a t^ ch a r aa
อัจฉราพร	z a t^ ch a r aa ph @@ n^
อัจฉราภรณ์	z a t^ ch a r aa ph @@ n^
อัจถพันธ์	z a t^ th a ph a n^
อัญชลี	z a n^ ch a l ii
อัญชสา	z a n^ ch a s aa
อัญชะลี	z a n^ ch a l ii
อัญชุลี	z a n^ ch u l ii
อัญญาฤทธิ์	z a n^ j aa r i t^
อัญรินทร์	z a n^ j a r i n^
อัฐมา	z a t^ th a m aa
อัฒรุต	z a t^ th a r u t^
อัตตพงษ์	z a t^ t a ph o ng^
อัทธนียา	z a t^ th a n ii j aa
อันดรูว์	z a n^ d a r uu
อันทวน	z a n^ th uua n^
อันวาร์	z a n^ w aa
อับดุลฮาฟิส	z a p^ d u n^ h aa f i t^
อัปสรสิริ	z a p^ s @@ n^ s i r i
อัมพร	z a m^ ph @@ n^
อัมมาร	z a m^ m aa n^
อัมราภัสร์	z a m^ m a r aa ph a t^
อัมรินทร์	z a m^ m a r i n^
อัยยวัฒน์	z a j^ j a j^ w a t^
อัลเบิร์ท	z a n^ b qq t^
อัศนัย	z a t^ s a n a j^
อัศนี	z a t^ s a n ii
อัศวพัทธ์	z a t^ s a w a ph a t^
อัศวัชร์	z a t^ s a w a t^
อัศวิน	z a t^ s a w i n^
อัศศิริ	z a t^ s a s i r i
อัษฎา	z a t^ s a d aa
อัษฎาพร	z a t^ s a d aa ph @@ n^
อัษฎาวุธ	z a t^ s a d aa w u t^
อัสนี	z a t^ s a n ii
อัสมา	z a t^ s a m aa
อาคม	z aa kh o m^
อาคิโกะ	z aa kh i k o
อาจหาญ	z aa t^ h aa n^
อาจอง	z aa t^ z o ng^
อาจารียา	z aa c aa r ii j aa
อาจินต์	z aa c i n^
อาชาครินต์	z aa ch aa khr i n^
อาชิรญาณ์	z aa ch i r a j aa
อาณัฐชัย	z aa n a t^ ch a j^
อาณัตพล	z aa n a t^ ph o n^
อาณัติ	z aa n a t^
อาณันย์	z aa n a n^
อาดาม	z aa d aa m^
อาทิตยา	z aa th i t^ th a j aa
อาทิตย์	z aa th i t^
อาทิมา	z aa th i m aa
อาทิวราห์	z aa th i w^ r aa
อานนท์	z aa n o n^
อานันท์	z aa n a n^
อานัส	z aa n a t^
อานิก	z aa n i k^
อาภัสณี	z aa ph a t^ n ii
อาภัสรา	z aa ph a t^ s a r aa
อาภัสสรา	z aa ph a t^ s a r aa
อาภา	z aa ph aa
อาภาพร	z aa ph aa ph @@ n^
อาภาภรณ์	z aa ph aa ph @@ n^
อาภาศิริ	z aa ph aa s i r i
อารดา	z aa r a d aa
อารมณ์	z aa r o m^
อารยะ	z aa r a j a
อารยา	z aa r a j aa
อารักษ์	z aa r a k^
อาริษา	z aa r i s aa
อารี	z aa r ii
อารียา	z aa r ii j aa
อารีย์	z aa r ii
อารีเพ็ญ	z aa r ii ph e n^
อารีเฟน	z aa r ii f ee n^
อาลิซาเบธ	z aa l i s aa b ee t^
อาลีฟ	z aa l ii p^
อาวุธ	z aa w u t^
อาศิส	z aa s i t^
อาษา	z aa s aa
อาสา	z aa s aa
อาสาฬห์	z aa s aa n^
อาเธอร์	z aa th qq
อาเมเรีย	z aa m ee r iia
อาเลซันแดร์	z aa l ee s a n^ dr
อำนวย	z a m^ n uua j^
อำนาจ	z a m^ n aa t^
อำพน	z a m^ ph o n^
อำพร	z a m^ ph @@ n^
อำพล	z a m^ ph o n^
อำพัน	z a m^ ph a n^
อิกคิวซัง	z i k^ kh i w^ s a ng^
อิงครัต	z i ng^ kh a r a t^
อิทธพร	z i t^ th a ph @@ n^
อิทธิ	z i t^ th i
อิทธิพล	z i t^ th i ph o n^
อิทธิพัทธ์	z i t^ th i ph a t^
อิทธิรัตน์	z i t^ th i r a t^
อิทธิสุนทร	z i t^ th i s u n^ th @@ n^
อิทธิเดช	z i t^ th i d ee t^
อินทนนท์	z i n^ th a n o n^
อินทร	z i n^ th a r a
อินทรัตน์	z i n^ th a r a t^
อินทรีน้อย	z i n^ s ii n @@ j^
อินทร์กรแก้ว	z i n^ kr k xx w^
อินทัช	z i n^ th a t^
อินทิรา	z i n^ th i r aa
อินทุรัตนา	z i n^ th u r a t^ t a n aa
อิรฟาน	z i r f aa n^
อิศรศักดิ์	z i t^ s a r a s a k^
อิศรา	z i t^ s a r aa
อิศรินทร์	z i t^ s a r i n^
อิศริยา	z i t^ s a r i j aa
อิษยา	z i t^ s a j aa
อิสมาแอล	z i s^ m aa z xx n^
อิสระ	z i t^ s a r a
อิสระพงศ์	z i t^ s a r a ph o ng^
อิสระพงษ์	z i t^ s a r a ph o ng^
อิสรา	z i t^ s a r aa
อิสราภรณ์	z i t^ s a r aa ph @@ n^
อิสราภา	z i t^ s a r aa ph aa
อิสริยะ	z i t^ s a r i j a
อิสสระ	z i t^ s a r a
อีฟ	z ii p^
อีเกิ้ล	z ii k qq n^
อีเซอร์	z ii s qq
อุกฤษ	z u kr i t^
อุกฤษณ์	z u kr i t^
อุดม	z u d o m^
อุดมชัย	z u d o m^ ch a j^
อุดมพร	z u d o m^ ph @@ n^
อุดมลักษณ์	z u d o m^ l a k^
อุดมศักดิ์	z u d o m^ s a k^
อุดมศิลป์	z u d o m^ s i n^
อุดมเดช	z u d o m^ d ee t^
อุดร	z u d @@ n^
อุตตม	z u t^ t a m a
อุทัย	z u th a j^
อุทัยวรรณ	z u th a j^ w a n^
อุทิศ	z u th i t^
อุทุมพร	z u th u m^ ph @@ n^
อุบลวรรณ	z u b o n^ w a n^
อุปดิศร์	z u p a d i t^
อุรัสยา	z u r a t^ s a j aa
อุษณากร	z u t^ s a n aa k @@ n^
อุษณีย์	z u t^ s a n ii
อุษา	z u s aa
อุษามณี	z u s aa m a n ii
อุสมาน	z u s a m aa n^
อุเทน	z u th ee n^
อุโฆษ	z u kh oo t^
อุไรรัตน์	z u r a j^ r a t^
อุไรวรรณ	z u r a j^ w a n^
อุ่นจิตร	z u n^ c i t^
อุ่นเรือน	z u n^ r vva n^
อู้ด	z uu t^
อู๊ด	z uu t^
อเล็กซานดร้า	z a l e k^ s aa n^ dr aa
อเล็กซานเดอร์	z a l e k^ s aa n^ d qq
อโณมา	z a n oo m aa
อโนชา	z a n oo ch aa
อโนเชาว์	z a n oo ch a w^
อ้อย	z @@ j^
ฮอชาลี	h @@ ch aa l ii
ฮันนี่	h a n^ n ii
ฮาน่า	h aa n aa
ฮารุ	h aa r u
ฮีโน่	h ii n oo
เกตุกินรี	k ee t^ k i n^ n a r ii
เกตุเสพย์สวัสดิ์	k ee t^ s ee p^ s a w a t^
เกตุเสพสวัสดิ์	k ee t^ s ee p^ s a w a t^
เกรซ	kr ee t^
เกริก	kr qq k^
เกริกกำพล	kr qq k^ k a m^ ph o n^
เกริกพล	kr qq k^ ph o n^
เกริกฤทธิ์	kr qq k^ r i t^
เกริกเกียรติ	kr qq k^ k iia t^
เกริกไกร	kr qq k^ kr a j^
เกรียง	kr iia ng^
เกรียงยศ	kr iia ng^ j o t^
เกรียงศักดิ์	kr iia ng^ s a k^
เกรียงไกร	kr iia ng^ kr a j^
เกล	k ee l^
เกวลิน	k ee w a l i n^
เกศริน	k ee t^ r i n^
เกษตร	k a s ee t^
เกษม	k a s ee m^
เกษมสันต์	k a s ee m^ s a n^
เกษราภรณ์	k ee t^ 1s a r aa ph @@ n^
เกียรติ	k iia t^
เกียรติกมล	k iia t^ k a m o n^
เกียรติชัย	k iia t^ t i ch a j^
เกียรติประวุฒิ	k iia t^ pr a w u t^
เกียรติพงษ์	k iia t^ t i ph o ng^
เกียรติศักดิ์	k iia t^ t i s a k^
เกื้อกูล	k vva k uu n^
เก็จมณี	k e t^ m a n ii
เก่งกาจ	k e ng^ k aa t^
เก้าแต้ม	k a w^ t xx m^
เขตร	kh ee t^
เขมนิจ	kh ee m^ m a n i t^
เขมรัชต์	kh ee m^ m a r a t^
เขมสรณ์	kh ee m^ m a s @@ n^
เขมิกา	kh ee m i k aa
เขมิศรา	kh ee m i t^ s a r aa
เขริกา	kh ee r i k aa
เขาค้อ	kh a w^ kh @@
เขาทราย	kh a w^ s aa j^
เขียวหวาน	kh iia w^ w aa n^
เข็มรัตน์	kh e m^ r a t^
เข็มอัปสร	kh e m^ z a p^ s @@ n^
เข้ม	kh ee m^
เคนี	kh ee n ii
เคย์	kh ee
เคลลี่	kh e n^ l ii
เงิน	ng q n^
เจจินตัย	c ee c i n^ t a j^
เจตกร	c ee t^ t a k @@ n^
เจตริน	c ee tr i n^
เจตสุภา	c ee t a s u ph aa
เจน	c ee n^
เจนจิรา	c ee n^ c i r aa
เจนนิษฐ์	c ee n^ n i t^
เจนนิเฟอร์	c ee n^ n i f qq
เจนนี่	c ee n^ n ii
เจนรบ	c ee n^ r o p^
เจนสุดา	c ee n^ s u d aa
เจนี่	c ee n ii
เจมส์	c ee m^
เจมี	c ee m ii
เจมี่	c ee m ii
เจริญ	c a r qq n^
เจริญจิตต์	c a r qq n^ c i t^
เจริญชัย	c a r qq n^ ch a j^
เจริญทอง	c a r qq n^ th @@ ng^
เจริญศักดิ์	c a r qq n^ s a k^
เจษฎา	c ee t^ s a d aa
เจษฎากร	c ee t^ s a d aa k @@ n^
เจษฎาภรณ์	c ee t^ s a d aa ph @@ n^
เจษฎ์พิพัฒ	c ee t^ ph i ph a t^
เจษฏา	c ee t^ s a d aa
เจสสิกา	c ee t^ s i k aa
เจสสิก้า	c ee t^ s i k aa
เจอาร์	c ee z aa
เจะอามิง	c e z aa m i ng^
เจินเจิน	c qq n^ c qq n^
เจิมมาศ	c qq m^ m aa t^
เจิมศักดิ์	c qq m^ s a k^
เจียมศักดิ์	c iia m^ s a k^
เจียร	c iia n^
เจี่ย	c iia
เจี๊ยบ	c iia p^
เจือ	c vva
เจือทอง	c vva th @@ ng^
เจเน็ต	c ee n e t^
เจ้ากอแก้วประกายกาวิล	c a w^ k @@ k xx w^ pr a k aa j^ j a k aa w i n^
เจ้ากาวิละวงศ์	c a w^ k aa w i l a w o ng^
เจ้ากุลวงศ์	c a w^ k u n^ l a w o ng^
เจ้าข่ายแก้ว	c a w^ kh aa j^ k xx w^
เจ้าจอมมารดาชุ่ม	c aa w^ c @@ m^ m aa n^ d aa ch u m^
เจ้าจอมมารดาทิพเกษร	c aa w^ c @@ m^ m aa n^ d aa th i p^ k ee s @@ n^
เจ้าจอมมารดาสังวาลย์	c aa w^ c @@ m^ m aa n^ d aa s a ng^ w aa n^
เจ้าจอมมารดาอ่อน	c aa w^ c @@ m^ m aa n^ d aa z @@ n^
เจ้าจอมอาบ	c aa w^ c @@ m^ z aa p^
เจ้าจอมเอิบ	c aa w^ c @@ m^ z qq p^
เจ้าจอมเอี่ยม	c aa w^ c @@ m^ z iia m^
เจ้าจอมเอื้อน	c aa w^ c @@ m^ z vva n^
เจ้าชื่น	c aa w^ ch vv n^
เจ้าดวงเดือน	c a w^ d uua ng^ d vva n^
เจ้าดารารัตน์	c a w^ d aa r aa r a t^
เจ้าบัวทิพย์	c aa w^ b uua th i p^
เจ้าบุญเลิศ	c aa w^ b u n^ l qq t^
เจ้าประดิษฐ์	c a w^ pr a d i t^
เจ้าพงศ์ธาดา	c a w^ ph o ng^ th aa d aa
เจ้าพงศ์แก้ว	c a w^ ph o ng^ k xx w^
เจ้าพงษ์กาวิล	c a w^ ph o ng^ k aa w i n^
เจ้าพงษ์อินทร์	c a w^ ph o ng^ z i n^
เจ้าพระยาศรีธรรมาธิเบศ	c a w^ phr a j aa s ii th a m^ m aa th i b ee t^
เจ้าระวีพันธุ์	c a w^ r a w ii ph a n^
เจ้าลดาคำ	c aa w^ l a d aa kh a m^
เจ้าวงศ์จันทร์	c aa w^ w o ng^ c a n^
เจ้าวงศ์สักก์	c aa w^ w o ng^ s a k^
เจ้าวรทัศน์	c aa w^ w a r a th a t^
เจ้าวัฒนัน	c aa w^ w a t^ th a n a n^
เจ้าศรีรัตน์	c a w^ s ii r a t^
เจ้าศิริประกาย	c a w^ s i r i pr a k aa j^
เจ้าศิริมา	c a w^ s i r i m aa
เจ้าสุคันธา	c aa w^ s u kh a n^ th aa
เจ้าอินทนนท์	c a w^ z i n^ th a n o n^
เจ้าเครือแก้ว	c a w^ khr vva k xx w^
เจ้าเดชา	c a w^ d ee ch aa
เจ้าแก้วมงคล	c a w^ k xx w^ m o ng^ kh o n^
เจ้าไชยณรงค์	c aa w^ ch a j^ n a r o ng^
เจ้าไชยสุริวงศ์	c aa w^ ch a j^ j a s u r i w o ng^
เจ๊ะอับดุลลาห์	c e z a p^ d u n^ l aa
เจ๊ะอิสมาแอ	c e z i s^ m aa z xx
เฉก	ch ee k^
เฉลิม	ch a l qq m^
เฉลิมชัย	ch a l qq m^ ch a j^
เฉลิมชาติ	ch a l qq m^ ch aa t^
เฉลิมพงศ์	ch a l qq m^ ph o ng^
เฉลิมพงษ์	ch a l qq m^ ph o ng^
เฉลิมพร	ch a l qq m^ ph @@ n^
เฉลิมพล	ch a l qq m^ ph o n^
เฉลิมพันธ์	ch a l qq m^ ph a n^
เฉลิมยศ	ch a l qq m^ j o t^
เฉลิมลักษณ์	ch a l qq m^ l a k^
เฉลิมวุฒิ	ch a l qq m^ w u t^
เฉลิมศักดิ์	ch a l qq m^ s a k^
เฉลียว	ch a l iia w^
เชน	ch ee n^
เชษฐรพี	ch ee t^ th a r a ph ii
เชษฐวุฒิ	ch ee t^ th a w u t^
เชษฐา	ch ee t^ th aa
เชษฐ์	ch ee t^
เชอรี่	ch qq r ii
เชาวน์	ch a w^
เชาวน์ดิศ	ch a w^ d i t^
เชาวน์วัศ	ch a w^ w a t^
เชาวรินธร์	ch a w^ w a r i n^ th a j^
เชาวเลข	ch a w^ w a l ee k^
เชาว์	ch a w^
เชาว์วัฒน์	ch a w^ w a t^
เชิด	ch qq t^
เชิดชัย	ch qq t^ ch a j^
เชิดพงศ์	ch qq t^ ph o ng^
เชี่ยวชาญ	ch iia w^ ch aa n^
เชื้อ	ch vva
เช็งจือ	ch e ng^ c vv
เซฟฟานี่	s ee p^ f aa n ii
เซลิน่า	s ee l i n aa
เฌอปราง	ch qq pr aa ng^
เฌอมาลย์	ch a z ee m aa n^
เดช	d ee t^
เดชดำรงค์	d ee t^ d a m^ r o ng^
เดชบดินทร์	d ee t^ b a d i n^
เดชฤทธิ์	d ee t^ r i t^
เดชวารินทร์	d ee t^ w aa r i n^
เดชสยาม	d ee t^ s a j aa m^
เดชอิศม์	d ee t^ z i t^
เดชา	d ee ch aa
เดชาพล	d ee ch aa ph o n^
เดชาวัต	d ee ch aa w a t^
เดวิด	d ee w i t^
เดียร์	d iia
เดียร์น่า	d iia n aa
เดียว	d iia w^
เดือน	d vva n^
เดือนวาด	d vva n^ w aa t^
เดือนเต็มดวง	d vva n^ t e m^ d uua ng^
เดือนเพ็ญ	d vva n^ ph e n^
เดโช	d ee ch oo
เด็ดขาด	d e t^ kh aa t^
เด็ดดวง	d e t^ d uua ng^
เด่น	d e n^
เด่นคุณ	d e n^ kh u n^
เด่นชัย	d e n^ ch a j^
เด่นชัยเล็ก	d e n^ ch a j^ l e k^
เด่นทักษิณ	d e n^ th a k^ s i n^
เด่นบูรพา	d ee n^ b uu r a ph aa
เด่นยโส	d e n^ j a s oo
เด่นเก้าแสน	d e n^ k aa w^ s xx n^
เด๋อ	d qq
เตช	t ee s^
เตชินท์	t ee ch i n^
เตมี	t ee m ii
เตรียม	tr iia m^
เตวิช	t ee w i t^
เตียง	t iia ng^
เตือน	t vva n^
เตือนใจ	t vva n^ c a j^
เต็ม	t e m^
เต็มฟ้า	t e m^ f aa
เทพ	th ee p^
เทพชัย	th ee p^ ch a j^
เทพนิมิตร	th ee p^ n i m i t^
เทพฤทธิ์	th ee p^ r i t^
เทพศิริ	th ee p^ s i r i
เทพิน	th ee ph i n^
เทพไชยา	th ee p^ ch a j^ j aa
เทพไท	th ee p^ th a j^
เทย่า	th ee j aa
เทวฤทธิ์	th ee w a r i t^
เทวัญ	th ee w a n^
เทวา	th ee w aa
เทวินทร์	th ee w i n^
เทศนา	th ee s a n aa
เทอดพงษ์	th qq t^ ph o ng^
เทอดศักดิ์	th qq t^ s a k^
เทอดเกียรติ	th qq t^ k iia t^
เทิดศักดิ์	th qq t^ s a k^
เทีย	th iia
เทียนชัย	th iia n^ ch a j^
เทียนทอง	th iia n^ th @@ ng^
เทียม	th iia m^
เทียมบุญ	th iia m^ b u n^
เทเรซ่า	th ee r ee s aa
เท่ง	th ee ng^
เธียยเกศ	th iia qq j^ k ee t^
เธียร	th iia n^
เนตร	n ee t^
เนตรน้อย	n ee t^ n @@ j^
เนติพงษ์	n ee t i ph o ng^
เนติมา	n ee t i m aa
เนวิน	n ee w i n^
เนศรา	n ee s a r aa
เนาวรัตน์	n a w^ w a r a t^
เนื่อง	n vva ng^
เบคเคนบาวร์	b ee k^ kh ee n^ b aa w^
เบญจณัฏฐ์	b e n^ c a n a t^
เบญจมาศ	b ee n^ c a m aa t^
เบญจรัตน์	b e n^ c a r a t^
เบญจวรรณ	b e n^ c a w a n^
เบญทราย	b ee n^ s aa j^
เบน	b ee n^
เบนจามิน	b ee n^ c aa m i n^
เบิกฤกษ์	b qq k^ r qq k^
เบ็ญจมาภรณ์	b e n^ c a m aa ph @@ n^
เปรม	pr ee m^
เปรมณัช	pr ee m^ n a t^
เปรมศักดิ์	pr ee m^ s a k^
เปรมสินี	pr ee m^ s i n ii
เปรมสุดา	pr ee m^ s u d aa
เปรมอนันต์	pr ee m^ z a n a n^
เปรมา	pr ee m aa
เปรมินทร์	p ee r a m i n^
เปรมินท์	p ee r a m i n^
เปรื่อง	pr vva ng^
เปรื่องปราชญ์	pr vva ng^ pr aa t^
เปลว	pl ee w^
เปลื้อง	pl vva ng^
เปล่งมณี	pl e ng^ m a n ii
เปาวลี	p aa w a l ii
เปาโล	p a w^ l oo
เปียทิพย์	p iia th i p^
เปียเชอร์	p iia ch qq
เปี่ยมวิไล	p iia m^ w i l a j^
เป็ด	p e t^
เป็นเอก	p e n^ z ee k^
เป้	p ee
เผดิมชัย	ph a d i m^ ch a j^
เผด็จศึก	ph a d e t^ s v k^
เผ่า	ph a w^
เพชร	ph e t^
เพชรคลองไผ่	ph ee t^ khl @@ ng^ ph a j^
เพชรงาม	ph e t^ ng aa m^
เพชรจอแฮ	ph e t^ c @@ h xx
เพชรชัยนาท	ph e t^ ch a j^ n aa t^
เพชรดา	ph e t^ ch a d aa
เพชรตาปี	ph e t^ t aa p ii
เพชรทวี	ph ee t^ th a w ii
เพชรทองคำ	ph ee t^ th @@ ng^ kh a m^
เพชรบางบอน	ph e t^ ch a b aa ng^ b @@ n^
เพชรมณี	ph e t^ m a n ii
เพชรมรกต	ph e t^ m @@ r a k o t^
เพชรยุพา	ph e t^ j u ph aa
เพชรรัตน์	ph e t^ ch a r a t^
เพชรราช	ph e t^ ch a r aa t^
เพชรรุ่ง	ph e t^ ch a r u ng^
เพชรสยาม	ph e t^ s a j aa m^
เพชรสุริยา	ph e t^ s u r i j aa
เพชรอู่ทอง	ph e t^ z uu th @@ ng^
เพชรา	ph ee t^ ch a r aa
เพชรเจริญ	ph ee t^ c a r qq n^
เพชรใหม่	ph e t^ m a j^
เพชรไทย	ph e t^ th a j^
เพทาย	ph ee th aa j^
เพรียวพันธ์	phr iia w^ ph a n^
เพลิน	phl qq n^
เพลินตา	phl qq n^ t aa
เพาะพุทธ	ph @ ph u t^
เพิ่มพล	ph qq m^ ph o n^
เพียงธาร	ph iia ng^ th aa n^
เพียร	ph iia n^
เพียวฤดี	ph iia w^ r v d ii
เพ็ญ	ph e n^
เพ็ญนภางค์	ph e n^ n a ph aa ng^
เพ็ญพนอ	ph e n^ phr n @@
เพ็ญพรรณ	ph e n^ ph a n^
เพ็ญพักตร์	ph e n^ ph a k^
เพ็ญศรี	ph e n^ s ii
เพ็ญศิริ	ph e n^ s i r i
เพ็ญเพ็ชร	ph e n^ ph e t^
เฟอร์รารี่	f qq r aa r ii
เฟี้ยวฟ้าว	f iia w^ f aa w^
เฟื่องวิชชุ์	f vva ng^ w i t^ ch u
เฟื้อ	f vva
เภา	ph a w^
เมฆ	m ee k^
เมจิ	m ee c i
เมตตา	m ee t^ t aa
เมทินี	m ee th i n ii
เมธัส	m ee th a t^
เมธาวี	m ee th aa w ii
เมธี	m ee th ii
เมย์	m ee
เมริสซ่า	m ee r i t^ s aa
เมลดา	m a l a d aa
เมษ	m ee t^
เมษา	m ee s aa
เมืองชล	m vva ng^ ch o n^
เมืองชัย	m vva ng^ ch a j^
เมืองทอง	m vva ng^ th @@ ng^
เมืองฟ้าเล็ก	m vva ng^ f aa l e k^
เมืองมนต์	m vva ng^ m o n^
เมืองไทย	m vva ng^ th a j^
เม็ดเงิน	m e t^ ng q n^
เยาวภา	j a w^ w a ph aa
เยาวลักษณ์	j a w^ w a l a k^
เยาวเรศ	j a w^ w a r ee t^
เย็น	j e n^
เร	r ee
เรวดี	r ee w^ w a d ii
เรวัต	r ee w a t^
เรวัตร์	r ee w a t^
เรวุฒิ	r ee w u t^
เรอเน	r qq n ee
เริงชัย	r qq ng^ ch a j^
เริงยศ	r qq ng^ j o t^
เรียม	r iia m^
เรืองฤทธิ์	r vva ng^ r i t^
เรืองวิทย์	r vva ng^ w i t^
เรืองศักดิ์	r vva ng^ s a k^
เรืองอุไร	r vva ng^ z u r a j^
เรืองเดช	r vva ng^ d ee t^
เรืองโรจน์	r vva ng^ r oo t^
เรืองไกร	r vva ng^ kr a j^
เรือหลวง	r vva l uua ng^
เลขา	l ee kh aa
เลอศักดิ์	l qq s a k^
เลิศ	l qq t^
เลิศทะเล	l qq t^ th a l ee
เลิศฤทธิ์	l qq t^ r i t^
เลิศศิลา	l qq t^ s i l aa
เลิศไทย	l qq t^ th a j^
เลียง	l iia ng^
เลื่อน	l vva n^
เลโอ	l ee z oo
เล็ก	l e k^
เวทย์	w ee t^
เวธกา	w ee t^ th a k aa
เวนิส	w ee n i t^
เวฟ	w ee p^
เวอาห์	w ee z aa
เวียง	w iia ng^
เศก	s o k^
เศกพล	s ee k^ k a ph o n^
เศกสิทธิ์	s ee k^ s i t^
เศรษฐพงศ์	s ee t^ th a ph o ng^
เศรษฐา	s ee t^ th aa
เสกรัก	s ee k^ r a k^
เสกศักดิ์	s ee k^ s a k^
เสกสรร	s ee k^ s a n^
เสกสรรค์	s ee k^ s a n^
เสกสันต์	s ee k^ s a n^
เสกสิทธิ์	s ee k^ s i t^
เสฐียรพงษ์	s ee t^ iia n^ ph o ng^
เสถียร	s a th iia n^
เสนาะ	s a n @
เสนีย์	s ee n ii
เสน่ห์	s a n ee
เสม	s ee m^
เสมา	s ee m aa
เสริม	s qq m^
เสริมคุณ	s qq m^ kh u n^
เสริมลาภ	s qq m^ l aa p^
เสริมศักดิ์	s qq m^ s a k^
เสรี	s ee r ii
เสรีพิศุทธ์	s ee r ii ph i s u t^
เสวตร	s a w ee t^
เสาวลักษณ์	s a w^ w a l a k^
เสาว์	s a w^
เสาหิน	s a w^ h i n^
เสียงซอ	s iia ng^ s @@
เสือ	s vva
เสือน้อย	s vva n @@ j^
เหนือธรณี	n vva th @@ r a n ii
เหม	h ee m^
เหมันต์	h ee m a n^
เหมือนฝัน	m vva n^ f a n^
เหมือนแพร	m vva n^ phr xx
เหรียญชัย	r iia n^ ch a j^
เหลี่ยมเพชร	l iia m^ ph e t^
เหลือเฟือ	l vva f vva
เหวง	w ee ng^
เห็ดเผาะ	h e t^ ph @
เห้ง	h ee o ng^
เอก	z ee k^
เอกก์	z ee k^
เอกชัย	z ee k^ k a ch a j^
เอกธนัช	z ee k^ th a n a t^
เอกนิษฐ์	z ee k a n i t^
เอกพงศ์	z ee k^ k a ph o ng^
เอกพจน์	z ee k^ ph o t^
เอกพร	z ee k^ k a ph @@ n^
เอกพันธ์	z ee k^ k a ph a n^
เอกภพ	z ee k^ 1k a ph o p^
เอกภาพ	z ee k^ k a ph aa p^
เอกภูมิ	z ee k^ k a ph uu m^
เอกยุทธ	z ee k^ k a j u t^
เอกรัตน์	z ee k^ k a r a t^
เอกราช	z ee k^ k a r aa t^
เอกลักษณ์	z ee k^ k a l a k^
เอกวิทย์	z ee k^ k a w i t^
เอกศักดิ์	z ee k^ k a s a k^
เอกสิทธิ์	z ee k^ s i t^
เอธัส	z ee th a t^
เอนก	z ee n o k^
เอฟ	z ee p^
เอมอร	z a m qq n^
เอมิกา	z ee m i k aa
เอมี่	z ee m ii
เอสเธอร์	z ee s^ th qq
เอิ้นขวัญ	z qq n^ khw a n^
เอี่ยม	z iia m^
เอื้อ	z vva
เอื้อน	z vva n^
เอื้อนจิตต์	z vva n^ c i t^
เอเลี่ยน	z ee l iia n^
เอ็มอร	z e m^ z @@ n^
แก้ว	k xx w^
แก้วกัลยา	k xx w^ k a n^ l a j aa
แก้วขวัญ	k xx w^ khw a n^
แก้วฟ้า	k xx w^ f aa
แก้วมณี	k xx w^ m a n ii
แก้วสรร	k xx w^ s a n^
แก้วเก้า	k xx w^ k aa w^
แคทรียา	kh xx t^ th a r ii j aa
แคทลียา	kh a th xx l ii j aa
แคทเธอรีน	kh xx t^ th qq r ii n^
แคนดี้	kh xx n^ d ii
แคลร์	khl xx
แคล้ว	khl xx w^
แจ็ค	c x k^
แจ่มใส	c x m^ s a j^
แจ้ง	c xx ng^
แชน	ch xx n^
แชมป์	ch xx m^
แชมเปญ	ch xx m^ p ee n^
แช่ม	ch xx m^
แซนดี้	s xx n^ d ii
แซมซั่น	s xx m^ s a n^
แซมมวล	s xx m^ m uua n^
แซมมี่	s xx m^ m ii
แดง	d xx ng^
แดงเหนือ	d xx ng^ n vva
แดน	d xx n^
แดนอรัญ	d xx n^ z a r a n^
แดนอรุณ	d xx n^ z a r u n^
แตน	t xx n^
แถมสิน	th xx m^ s i n^
แทน	th xx n^
แทนคุณ	th xx n^ kh u n^
แทมมารีน	th xx m^ m aa r ii n^
แท่งทอง	th xx ng^ th @@ ng^
แท้	th xx
แนบ	n xx p^
แปลก	pl xx k^
แผน	ph xx n^
แผ้ว	ph x w^
แพ	ph xx
แพร	phr xx
แพรวนภา	phr xx w^ n a ph aa
แพรวา	phr xx w aa
แพรอิศรา	phr xx z i t^ s a r aa
แมงปอ	m xx ng^ p @@
แมน	m xx n^
แมนรัตน์	m xx n^ r a t^
แม็ก	m x k^
แรคำ	r xx kh a m^
แวมาฮาดี	w xx m aa h aa d ii
แวว	w xx w^
แววตา	w xx w^ t aa
แสง	s xx ng^
แสงชัย	s xx ng^ ch a j^
แสงดา	s xx ng^ d aa
แสงธรรม	s xx ng^ th a m^
แสงมณี	s xx ng^ m a n ii
แสงศักดา	s xx ng^ s a k^ d aa
แสงสี	s xx ng^ s ii
แสงสุรีย์	s xx ng^ s u r ii
แสงหิรัญ	s xx ng^ h i r a n^
แสงอรุณ	s xx ng^ z a r u n^
แสงเทียนน้อย	s xx ng^ th iia n^ n @@ j^
แสงเพชร	s xx ng^ ph e t^
แสตมป์	s a t xx m^
แสน	s xx n^
แสนชัย	s xx n^ ch a j^
แสนศักดิ์	s xx n^ s a k^
แสนเมืองเลย	s xx n^ m vva ng^ l qq j^
แหลม	l xx m^
แหลมทอง	l xx m^ th @@ ng^
แหวนเพชร	w xx n^ ph ee t^
แอ	z xx
แองจิล่า	z xx ng^ c i l aa
แองจี้	z xx ng^ c ii
แอน	z xx n^
แอนดริว	z xx n^ dr i w^
แอนดรูว์	z xx n^ dr uu
แอนดี้	z xx n^ d ii
แอนนา	z xx n^ n aa
แอนนี่	z xx n^ n ii
แอนเดรีย	z xx n^ dr iia
แอนโทเนีย	z xx n^ th oo n iia
แอนโธนี	z xx n^ th oo n ii
แอร์	z xx
แฮร์มันน์	h xx m a n^
โกวิท	k oo w i t^
โกวิทย์	k oo w i t^
โกศล	k oo s o n^
โกสินทร์	k oo s i n^
โก๊ะตี๋	k o t ii
โฆษวิส	kh oo t^ s a w i t^
โฆษา	kh oo s aa
โฆษิต	kh oo s i t^
โฆสิต	kh oo s i t^
โจอี้	c oo z ii
โฉมฉาย	ch oo m^ ch aa j^
โชกุน	ch oo k u n^
โชคชัย	ch oo k^ ch a j^
โชคทวี	ch oo k^ th a w ii
โชคสมาน	ch oo k^ s a m aa n^
โชคอนันต์	ch oo z a n a n^
โชติ	ch oo t^
โชติกา	ch oo t i k aa
โชติพัฒน์	ch oo t i ph a t^
โชติมา	ch oo t i m aa
โชติรส	ch oo t i r o t^
โชติวัฒน์	ch oo t^ w a t^
โชเล่ย์	ch oo l ee
โดม	d oo m^
โดเรม่อน	d oo r ee m @@ n^
โดโด้	d oo d oo
โตนนท์	t oo n o n^
โตโต้	t ee t oo
โต๊ะ	t o
โทนี่	th oo n ii
โนรี	n oo r ii
โน้ต	n oo t^
โปฎก	p oo d o k^
โปเกม่อน	p oo k ee m @@ n^
โป่งขาม	p oo ng^ kh aa m^
โผน	ph oo n^
โพธิพงษ์	ph oo th i ph o ng^
โพธิ์	ph oo
โพธิ์ไทร	ph oo s a j^
โพล้ง	phl oo ng^
โฟกัส	f oo k a t^
โภคิน	ph oo kh i n^
โมนา	m oo n aa
โมรียา	m oo r ii j aa
โมฮามัดยาสรี	m oo h aa m a t^ j aa s a r ii
โม่	m oo
โยธิน	j oo th i n^
โย่ง	j oo ng^
โรจน์	r oo t^
โรช	r oo t^
โรสแมรี่	r oo t^ m xx r ii
โรเบิร์ต	r oo b qq t^
โลมา	l oo m aa
โศภิดา	s oo ph i d aa
โสภณ	s oo ph o n^
โสภา	s oo ph aa
โสภาค	s oo ph aa k^
โสภาพรรณ	s oo ph aa ph a n^
โสภิตนภา	s oo ph i t^ t a n a ph aa
โสภิตา	s oo ph i t aa
โสรยา	s oo r a j aa
โสรัจจา	s oo r a t^ c aa
โหน่ง	n oo ng^
โอบนิธิ	z oo p^ n i th i
โอปอ	z oo p @@
โอภาส	z oo ph aa t^
โอม	z oo m^
โอลิเวอร์	z oo l i w qq
โอสถ	z oo s o t^
โอฬาร	z oo l aa n^
โอเล่ห์	z oo l ee
โอเล่ห์ดง	z oo l ee d o ng^
ใกล้รุ่ง	kl a j^ r u ng^
ใจ	c a j^
ใบเตย	b a j^ t qq j^
ใหญ่	j a j^
ใหม่	m a j^
ไกร	kr a j^
ไกรภพ	kr a j^ ph o p^
ไกรฤกษ์	kr a j^ r qq k^
ไกรลาศ	kr a j^ l aa t^
ไกรศรี	kr a j^ s ii
ไกรศักดิ์	kr a j^ s a k^
ไกรสร	kr a j^ s @@ n^
ไกรเกียรติ	kr a j^ k iia t^
ไกวัล	k a j^ w a n^
ไก่ชน	k a j^ ch o n^
ไขศรี	kh a j^ s ii
ไชยยศ	ch a j^ j o t^
ไชยรัตน์	ch a j^ j a r a t^
ไชยลังกา	ch a j^ l a ng^ k aa
ไชยวัฒน์	ch a j^ j a w a t^
ไชยศิริ	ch a j^ s i r i
ไชยา	ch a j^ j aa
ไดอาน่า	d a j^ z aa n aa
ไตรทิพย์สุดา	tr a j^ th i p^ s u d aa
ไตรภพ	tr a j^ ph o p^
ไตรรงค์	tr a j^ r o ng^
ไตรรัตน์	tr a j^ r a t^
ไท	th a j^
ไทกร	th a j^ k @@ n^
ไทย	th a j^
ไทรโยค	s a j^ j oo k^
ไทสัน	th a j^ s a n^
ไทเกอร์	th a j^ k qq
ไทแทน	th a j^ th xx n^
ไปรมา	pr a j^ m aa
ไปรยา	pr a j^ j aa
ไผ่	ph a j^
ไผ่ผารบ	ph a j^ ph aa r o p^
ไพจิต	ph a j^ c i t^
ไพจิตร	ph a j^ c i t^
ไพฑูรย์	ph a j^ th uu n^
ไพบูลย์	ph a j^ b uu n^
ไพบูลย์เกียรติ	ph a j^ b uu n^ k iia t^
ไพร	phr a j^
ไพรวัลย์	phr a j^ w a n^
ไพรัช	ph a j^ r a t^
ไพรัตน์	ph a j^ r a t^
ไพวรินทร์	ph a j^ w a r i n^
ไพศาล	ph a j^ s aa n^
ไพโรจน์	ph a j^ r oo t^
ไฟแรง	f a j^ r xx ng^
ไมค์	m a j^
ไมเคิล	m a j^ kh qq n^
ไมเคิ่น	m a j^ kh qq n^
ไรน่าน	r a j^ n aa n^
ไวพจน์	w a j^ ph o t^
ไศล	s a l a j^
ไสยวิชญ์	s a j^ j a w i t^
ไสยาสน์	s a j^ j aa t^
ไสล	s a l a j^
ไสว	s a w a j^
ไหมไทย	m a j^ th a j^
ไอยวริญท์	z a j^ j a w a r i
ไอรดา	z a j^ r a d aa
ไอริณ	z a j^ r i n^
ไอศวรรยา	z a j^ s a w a n^ j aa
