กงทอง	k o ng^ th @@ ng^
กงเพชร	k o ng^ ph ee t^
กตะศิลา	k a t a s i l aa
กตฺปฺญฺโญ	k @@ t @@ p j oo
กนกนทีสวัสดิ์	k a n o k^ n a th ii s a w a t^
กนิตศรีบำเพ็ญ	k a n i t^ s ii b a m^ ph e n^
กปิลกาญจน์	k a p i n^ k aa n^
กมลรัตนกุล	k a m o n^ r a t^ t a n a k u n^
กมลวิศิษฎ์	k a m o n^ w i s i t^
กมลเพชร	k a m o n^ ph ee t^
กมลเพ็ชร	k a m o n^ ph e t^
กมลเวชช	k a m o n^ l a w ee t^ ch a
กมุลทะลา	k a m u n^ th a l aa
กรกชมาศ	k @@ r a k o t^ m aa t^
กรกต	k @@ r a k o t^
กรทิพย์	k @@ n^ th i p^
กรมดิษฐ์	kr o m^ d i t^
กรมพระปรมานุชิตชิโนรส	kr o m^ m a phr a p @@ r a m aa n u ch i t^ ch i n oo r o t^
กรมพระยาปวเรศวริยาลงกรณ์	kr o m^ phr a j aa p a w a r ee s uua n^ aa l o ng^ k @@ n^
กรมพระยาวชิรญาณวโรรส	kr o m^ phr a j aa w a ch i r a j aa n a w a r oo r o t^
กรมสมเด็จพระเทพรัตนราชสุดาฯ	kr o m^ s o m^ d e t^ phr a th ee r aa ch a s u d aa
กรรณสูต	k a n^ n a s uu t^
กรรณาธิกรณ์	k a n^ n aa th i k @@ n^
กรรณิการ์	k a n^ n i k aa
กรรรัตนสูตร	k a n^ r a t^ t a n a s uu t^
กรวยทอง	kr uua j^ th @@ ng^
กรสุทธิ์ไรวรรณ	k a r a s u t^ r a j^ w a n^
กรสูต	k @@ n^ s uu t^
กระจ่างศาสตร์	kr a c aa ng^ s aa t^
กระทิงแดง	kr a th i ng^ d xx ng^
กระทิงแดงยิม	kr a th i ng^ d xx ng^ j i m^
กระแสสินธุ์	kr a s xx s i n^
กระโดนชำนาญ	kr a d oo n^ ch a m^ n aa n^
กรัยวิเชียร	kr a j^ w i ch iia n^
กรานสำโรง	kr aa n^ s a m^ r oo ng^
กรินชัย	kr i n^ ch a j^
กรีกุล	kr ii k u n^
กรีพลฤกษ์	kr ii phl r qq k^
กรุณา	k a r u n aa
กรุแก้ว	kr u k xx w^
กรเกษม	k @@ n^ k a s ee m^
กฤดากร	kr i t^ d aa k @@ n^
กฤตตานุกูล	kr i t^ t aa n u k uu n^
กฤตบุญญาลัย	kr i t^ b u n^ j aa l a j^
กฤตยากีรณ	kr i t^ t a j aa k ii r o n^
กฤษฎี	kr i t^ s a d ii
กฤษณคุปต์	kr i t^ s a n a kh u p^
กฤษณายุธ	kr i t^ s a n aa j u t^
กฤษดา	kr i t^ s a d aa
กฤษบำรุง	kr i t^ s a b a m^ r u ng^
กลมกล่อม	kl o m^ kl @ m^
กลมเกลี้ยง	kl o m^ kl iia ng^
กลมแก้ว	kl o m^ k xx w^
กลองเชียร์	kl @@ ng^ ch iia
กลอส	kl @@ t^
กลัสนิมิ	kl a t^ n i m i
กลางณรงค์	kl aa ng^ n a r o ng^
กลินทะ	kl i n^ th a
กลิ่นกุหลาบหิรัญ	kl i n^ k u l aa p^ h i r a n^
กลิ่นประทุม	kl i n^ pr a th u m^
กลิ่นสุคนธ์	kl i n^ s u kh o n^
กลิ่นสุมาลย์	kl i n^ s u m aa n^
กลิ่นเกษร	kl i n^ k ee s @@ n^
กลิ่นโกสุม	kl i n^ k oo s u m^
กล่อมทองสุข	kl @ m^ th @@ ng^ s u k^
กล่อมน้อย	kl @@ m^ n @@ j^
กล่อมพงษ์	kl @ m^ ph o ng^
กล้วยไม้งาม	kl uua j^ m aa j^ ng aa m^
กล้าศึก	kl aa s v k^
กสิวัฒน์	k a s i w a t^
กองการ	k @@ ng^ k aa n^
กองกิริต	k @@ ng^ k i r i t^
กองจันทร์	k @@ ng^ c a n^
กองตระการ	k @@ ng^ tr a k aa n^
กองลาภ	k @@ ng^ l aa p^
กองสี	k @@ ng^ s ii
กองสุข	k @@ ng^ s u k^
กองเพียร	k @@ ng^ ph iia n^
กอบจิตติ	k @@ p^ c i t^ t i
กอมะ	k @@ m a
กอแสงเรือง	k @@ s xx ng^ r vva ng^
กฮาร์	k oo h aa
กะท้อน	k a th @@ n^
กังสดาร	k a ng^ s a d aa n^
กังสดาลย์	k a ng^ s a d aa n^
กัจฉปานันท์	k a t^ ch a p aa n a n^
กัญญามาลย์	k a n^ j aa m aa n^
กัณหา	k a n^ h aa
กันกลับ	k a n^ kl a p^
กันตพจน์	k a n^ t a ph o t^
กันตะบุตร	k a n^ t a b u t^
กันทอง	k a n^ th @@ ng^
กันทา	k a n^ th aa
กันนุลา	k a n^ n u l aa
กันภัย	k a n^ ph a j^
กันยะโรจน์	k a n^ j a r oo t^
กันหนู	k a n^ n uu
กันหลง	k a n^ l o ng^
กัมพูสิริ	k a m^ ph uu s i r i
กัลป์ตินันท์	k a n^ t i n a n^
กัลยาณบัณฑิต	k a n^ l a j aa n a b a n^ d i t^
กัลยาณพงศ์	k a n^ l a j aa n a ph o ng^
กัลยาณมิตร	k a n^ l a j aa n a m i t^
กัลยาณี	k a n^ l a j aa n ii
กัลยาศิริ	k a n^ l a j aa s i r i
กัลย์จาฤก	k a n^ c aa r v k^
กางอิ่ม	k aa ng^ z i m^
กาญจนชูศักดิ์	k aa n^ c a n a ch uu s a k^
กาญจนประกร	k aa n^ c a n a pr a k @@ n^
กาญจนพาสน์	k aa n^ c a n a ph aa t^
กาญจนระพี	k aa n^ c a n a r a ph ii
กาญจนรัตน์	k aa n^ c a n a r a t^
กาญจนรินทร์	k aa n^ c a n a r i n^
กาญจนวัฒน์	k aa n^ c a n a w a t^
กาญจนศรี	k aa n^ c a n a s ii
กาญจนสมศักดิ์	k aa n^ c a n a s o m^ s a k^
กาญจนหิรัญ	k aa n^ c a n a h i r a n^
กาญจนะจิตรา	k aa n^ c a n a c i t^ tr aa
กาญจนะผลิน	k aa n^ c a n a phl i n^
กาญจนาลัย	k aa n^ c a n aa l a j^
กาญจนไพริน	k aa n^ c a n a ph a j^ r i n^
กาญจันดา	k aa n^ c a n^ d aa
กานตรัตน์	k aa n^ t a r a t^
กานต์วัฒนกุล	k aa n^ w a t^ th a n a k u n^
กานู	k aa n uu
กายสิทธิ์	k aa j^ j a s i t^
การทิพย์	k aa n^ th i p^
การพจน์	k aa n^ ph o t^
การพิศิษฎ์	k aa n^ ph i s i t^
การวัฒนาศิริกุล	k aa n^ w a t^ th a n aa s i r i k u n^
การสมนุช	k aa n^ s o m^ n u t^
การะเกตุ	k aa r a k ee t^
การิกาญจน์	k aa r i k aa n^
การุญ	k aa r u n^
การุณวงศ์	k aa r u n^ w o ng^
กาศยปนันทน์	k aa t^ p a n a n^
กาเหย็ม	k aa j x m^
กาแมน	k aa m xx n^
กาไชย	k aa ch a j^
กาไวย์	k aa w a j^
กำจรเดช	k a m^ c @@ r a d ee t^
กำจัดภัย	k a m^ c a t^ ph a j^
กำธรเจริญ	k a m^ th @@ n^ c a r qq n^
กำภู	k a m^ ph uu
กำลังมาก	k a m^ l a ng^ m aa k^
กำลังเอก	k a m^ l a ng^ z ee k^
กำเนิดพลอย	k a m^ n qq t^ phl @@ j^
กิจถาวร	k i t^ c a th aa w @@ n^
กิจนิตย์ชีว์	k i t^ c a n i t^ ch ii w^
กิจบุญชู	k i t^ b u n^ ch uu
กิจประสาน	k i t^ pr a s aa n^
กิจพงษ์ศรีธาดา	k i t^ c a ph o ng^ s ii th aa d aa
กิจมงคลศักดิ์	k i t^ c a m o ng^ kh o n^ l a s a k^
กิจวรลักษณ์	k i t^ w @@ r a l a k^
กิจวิจารณ์	k i t^ w i c aa n^
กิจสุวรรณ	k i t^ s u w a n^
กิจเจริญ	k i t^ c a r qq n^
กิจเลิศไพโรจน์	k i t^ l qq t^ ph a j^ r oo t^
กิตติกรเจริญ	k i t^ t i k @@ n^ c a r qq n^
กิตติกุลวงศ์	k i t^ t i k u n^ l a w o ng^
กิตติขจร	k i t^ t i kh a c @@ n^
กิตติธเนศวร	k i t^ t i th a n ee s uua n^
กิตติพรภาณุวงศ์	k i t^ t i ph @@ n^ ph aa n u w o ng^
กิตติพัฒนะ	k i t^ t i ph a t^ th a n a
กิตติมงคลเลิศ	k i t^ t i m o ng^ kh o n^ l qq t^
กิตติวัฒน์	k i t^ t i w a t^
กิตติสาร	k i t^ t i s aa n^
กิตติสาระ	k i t^ t i s aa r a
กิตติเกษม	k i t^ t i k a s ee m^
กิติกุล	k i t i k u n^
กิติธรากุล	k i t i th a r aa k u n^
กิติยพันธ์	k i t i j a ph a n^
กิติยากร	k i t i j aa k @@ n^
กิมขาว	k i m^ kh aa w^
กิมสร้าง	k i m^ s aa ng^
กิราตกะ	k i r aa t a k a
กิ่งคำวงศ์	k i ng^ kh a m^ w o ng^
กิ่งชัชวาลย์	k i ng^ ch a t^ ch a w aa n^
กิ่งทอง	k i ng^ th @@ ng^
กิ่งมณี	k i ng^ m a n ii
กิ่งวรรณ	k i ng^ w a n^
กิ่งศักดิ์	k i ng^ s a k^
กิ่งเพชร	k i ng^ ph ee t^
กิ่งแก้ว	k i ng^ k xx w^
กิ่งโพยม	k i ng^ ph a j oo m^
กียอง	k ii j @@ ng^
กีรติเกียรติ	k ii r a t i k iia t^
กุญชร	k u n^ ch @@ n^
กุนัน	k u n a n^
กุมชพร	k u m^ ch a ph @@ n^
กุลชล	k u n^ l a ch o n^
กุลชัยรัตนา	k u n^ ch a j^ r a t^ t a n aa
กุลดิลก	k u n^ l a d i l o k^
กุลตังวัฒนา	k u n^ t a ng^ w a t^ th a n aa
กุลนันท์วัฒน์	k u l a n a n^ w a t^
กุลนาถศิริ	k u n^ l a n aa t^ s i r i
กุลน้อย	k u n^ n @@ j^
กุลปรียาวัฒน์	k u n^ l a pr ii j aa w a t^
กุลพงษ์วณิชย์	k u n^ l a ph o ng^ w a n i t^
กุลมาตย์	k u n^ l a m aa t^
กุลละวณิชย์	k u n^ l a w a n i t^
กุลวงษา	k u n^ w o ng^ s aa
กุลศรี	k u n^ l a s ii
กุลสุนทรรัตน์	k u n^ s u n^ th @@ n^ r a t^
กุลเจริญ	k u n^ c a r qq n^
กุลไพศาล	k u n^ ph a j^ s aa n^
กุวานนท์	k u w aa n o n^
กุศลคูณสิริ	k u s o n^ kh uu n^ s i r i
กุศลมโนมัย	k u s o n^ l a m a n oo m a j^
กุศลาสัย	k u s o n^ l a w^ s a j^
กุสตาฟสัน	k u s a t aa p^ s a n^
กุสุมรสนานันท์	k u s u m @@ r a s a n aa n a n^
กูรมะโรหิต	k uu r a m a r oo h i t^
กูโน	k uu n oo
กู๊ด	k uu t^
ก่อนบ่ายคลายเครียด	k @@ n^ b aa j^ khl aa j^ khr iia t^
ก่อผล	k @@ ph o n^
ก่อสุวรรณ	k @@ s u w a n^
ก่อเกียรติ	k @@ k iia t^
ก่อเกียรติยิม	k @@ k iia t^ t i j i m^
ก้องธรนินทร์	k @@ ng^ th @@ r a n i n^
ก้อนจันทร์	k @@ n^ c a n^
ก๊กผล	k o k^ ph o n^
ก๊กรัมย์	k o k^ r a m^
ขจรประศาสน์	kh a c @@ n^ pr a s aa t^
ขจรมาลี	kh a c @@ n^ m aa l ii
ขจรรุ่งศิลป์	kh a c @@ n^ r u ng^ s i n^
ขจรไชยกุล	kh a c @@ n^ ch a j^ j a k u n^
ขจรไชยกูล	kh a c @@ n^ ch a j^ j a k uu n^
ขจัดภัย	kh a c a t^ ph a j^
ขจิตสุวรรณ	kh a c i t^ s u w a n^
ขนนกยูง	kh o n^ n o k^ j uu ng^
ขมิ้นทอง	kh a m i n^ th @@ ng^
ขยันยิ่ง	kh a j a n^ j i ng^
ขลังธรรมเนียม	khl a ng^ th a m^ n iia m^
ขลิบทอง	khl i p^ th @@ ng^
ขลิบเงิน	khl i p^ ng q n^
ขวนขวาย	kh uua n^ khw aa j^
ขวัญฐิติ	khw a n^ j a th i t i
ขวัญอ่างทอง	khw a n^ z aa ng^ th @@ ng^
ขวัญเมือง	khw a n^ m vva ng^
ขวัญโพธิ์ไทย	khw a n^ ph oo th a j^
ขันติวรบท	kh a n^ t i w @@ r a b o t^
ขันทปราบ	kh a n^ th a pr aa p^
ขันธสะอาด	kh a n^ th a s a z aa t^
ขานอัน	kh aa n^ z a n^
ขามช่วง	kh aa m^ ch uua ng^
ขาวขำ	kh aa w^ kh a m^
ขาวงาม	kh aa w^ ng aa m^
ขาวทอง	kh aa w^ th @@ ng^
ขาวละออ	kh aa w^ l a z @@
ขาวสะอาด	kh aa w^ s a z aa t^
ขำกฤษ	kh a m^ kr i t^
ขำคมกุล	kh a m^ kh o m^ k u n^
ขำทอง	kh a m^ th @@ ng^
ขำนุรักษ์	kh a m^ n u r a k^
ขำศรีบุศ	kh a m^ s ii b u t^
ขำหิรัญ	kh a m^ h i r a n^
ขำเปี่ยม	kh a m^ p iia m^
ขุนเณร	kh u n^ n ee n^
ขุนแขวง	kh u n^ khw xx ng^
ขุนโสม	kh u n^ s oo m^
คงคาเขตร	kh o ng^ kh aa kh ee t^
คงทอง	kh o ng^ th @@ ng^
คงทัน	kh o ng^ th a n^
คงนาค	kh o ng^ n aa k^
คงประสิทธิ์	kh o ng^ pr a s i t^
คงมาลัย	kh o ng^ m aa l a j^
คงยศ	kh o ng^ j o t^
คงยิ่งยง	kh o ng^ j i ng^ j o ng^
คงราศรี	kh o ng^ r aa s ii
คงวุฒิปัญญา	kh o ng^ w u t^ th i p a n^ j aa
คงศิริถาวร	kh o ng^ s i r i th aa w @@ n^
คงสมพงษ์	kh o ng^ s o m^ ph o ng^
คงสิริ	kh o ng^ s i r i
คงสุวรรณ	kh o ng^ s u w a n^
คงอุดม	kh o ng^ z u d o m^
คงเทพ	kh o ng^ th ee p^
คงเพชร	kh o ng^ ph ee t^
คงเสรี	kh o ng^ s ee r ii
คงแก้ว	kh o ng^ k xx w^
คงแนวดี	kh o ng^ n xx w^ d ii
คงไทย	kh o ng^ th a j^
คชน่วม	kh o t^ n uua m^
คชพลายุกต์	kh o t^ phl aa j u k^
คชรัตน์	kh o t^ ch a r a t^
คชสีห์	kh o t^ ch a s ii
คชหิรัญ	kh o t^ ch a h i r a n^
คชเสนี	kh o t^ ch a s ee n ii
คณา	kh a n aa
คณาธีรกุล	kh a n aa th ii r a k u n^
คณารศ	kh a n aa r o t^
คนชม	kh o n^ ch o m^
คนด่านเกวียน	kh o n^ d aa n^ kw iia n^
คนสมบูรณ์	kh o n^ s o m^ b uu n^
คนหาญ	kh o n^ h aa n^
ครบุรีธีรโชติ	khr b u r ii th ii r a ch oo t^
คราประยูร	khr aa pr a j uu n^
คริสตัน	khr i s^ t a n^
คริสเตนเซ่น	khr i t^ s a t ee n^ s e n^
ครุฑขุนทด	khr u t^ kh u n^ th o t^
ครุธามาศ	khr u th aa m aa t^
คลองเตย	khl @@ ng^ t qq j^
คลังผา	khl a ng^ ph aa
คลังเพชร	khl a ng^ ph ee t^
คลังแสง	khl a ng^ s xx ng^
คลาร์ค	khl aa k^
คล่องตรวจโรค	khl @ ng^ tr uua t^ r oo k^
คล่องผจญ	khl @ ng^ ph a c o n^
คล่องวรานนท์	khl @ ng^ w a r aa n o n^
คล้ามไพบูลย์	khl aa m^ ph a j^ b uu n^
คล้ายนก	khl aa j^ n o k^
คล้ายสีทอง	khl aa j^ s ii th @@ ng^
คล้ายอุดม	khl aa j^ z u d o m^
คล้ายแต้	khl aa j^ t xx
ควรสงวน	kh uua n^ s a ng uua n^
ควรหา	kh uua n^ h aa
คอตแลนด์	kh @@ t^ l xx n^
คอมันตร์	kh @@ m a n^
คอร์ป	kh @@ p^
คัญทัพ	kh a n^ th a p^
คันธจันทร์	kh a n^ th a c a n^
คันธนู	kh a n^ th a n uu
คันธยศ	kh a n^ j o t^
คันธวงศ์	kh a n^ th a w o ng^
คัมภีรญาณนนท์	kh a m^ ph ii r a j aa n a n o n^
คัมมินส์	kh a m^ m i n^
คาร์	kh aa
คาห์ล	kh aa l^
คาฮันดิง	kh aa h a n^ d i ng^
คำขำ	kh a m^ kh a m^
คำคล้าย	kh a m^ khl aa j^
คำจันทร์	kh a m^ c a n^
คำนวณศิลป์	kh a m^ n uua n^ n a s i n^
คำบัว	kh a m^ b uua
คำประกอบ	kh a m^ pr a k @@ p^
คำภีร์	kh a m^ ph ii
คำวงศ์	kh a m^ w o ng^
คำวิลัยศักดิ์	kh a m^ w i l a j^ s a k^
คำศรี	kh a m^ s ii
คำสร้อย	kh a m^ s @@ j^
คำสิงห์	kh a m^ s i ng^
คำสุข	kh a m^ s u k^
คำอ้วน	kh a m^ z uua n^
คำเอี่ยม	kh a m^ z iia m^
คำโสภา	kh a m^ s oo ph aa
คำไหม	kh a m^ m a j^
คิคคิคสะระณัง	kh i k^ kh i k^ s a r a n a ng^
คินนี่	kh i n^ n ii
คิ้วฮก	kh i w^ h o k^
คีแนน	kh ii n xx n^
คุณกิตติ	kh u n^ k i t^ t i
คุณนาอนุวิทย์	kh u n^ n aa z a n u w i t^
คุณปลื้ม	kh u n^ pl vv m^
คุณวิบูลย์	kh u n^ n a w i b uu n^
คุณวุฒิ	kh u n^ n a w u t^
คุณสิงห์	kh u n^ n a s i ng^
คุณะเกษมธนาวัฒน์	kh u n a k a s ee m^ th a n aa w a t^
คุณากร	kh u n aa k @@ n^
คุณาธิปอภิสิริ	kh u n aa th i p^ p a z a ph i s i r i
คุณานิธิพงศ์	kh u n aa n i th i ph o ng^
คุณาวงศ์	kh u n aa w o ng^
คุณาวุฒิ	kh u n aa w u t^
คุณไชย	kh u n^ ch a j^
คุนผลิน	kh u n^ phl i n^
คุนาประถม	kh u n aa pr a th o m^
คุปตะวาทิน	kh u p^ t a w aa th i n^
คุปต์ธนโรจน์	kh u p^ th a n a r oo t^
คุประตกุล	kh u p^ r a t a k u n^
คุโด	kh u d oo
คุ้มผล	kh u m^ ph o n^
คุ้มพญา	kh u m^ ph a j aa
คุ้มพันธ์	kh u m^ ph a n^
คุ้มวงศ์	kh u m^ w o ng^
คุ้มสุวรรณ	kh u m^ s u w a n^
คุ้มโชคไพศาล	kh u m^ ch oo k^ ph a j^ s aa n^
คูกิมิยะ	kh uu k i m i j a
คูณมี	kh uu n^ m ii
คูลลิ่ง	kh uu n^ l i ng^
คูอาริยะกุล	kh uu z aa r i j a k u n^
คูเกษมกิจ	kh uu k a s ee m^ k i t^
คูเป่ยจง	kh uu p qq j^ c o ng^
คเชนทร์นุกูล	kh a j^ ch ee n^ n u k uu n^
ค่อมสิงห์	kh @ m^ s i ng^
ค่อยจะโป๊ะ	kh @@ j^ c a p o
ฆฤตภูริภาคย์	kh a r i t^ ph uu r i ph aa k^
ฆัมภิรานนท์	kh a m^ ph i r aa n o n^
งั่วลำหิน	ng uua l a m^ h i n^
งามทิพย์	ng aa m^ th i p^
งามพริ้ง	ng aa m^ phr i ng^
งามสนิท	ng aa m^ s a n i t^
งามสม	ng aa m^ s o m^
งามสรรพ์	ng aa m^ s a n^
งามสุคนธภูษิต	ng aa m^ s u kh o n^ th a ph uu s i t^
งามเจริญ	ng aa m^ c a r qq n^
งามเนตร	ng aa m^ n ee t^
จงจอหอ	c o ng^ c @@ h @@
จงจิตร	c o ng^ c i t^
จงจินตนาการ	c o ng^ c i n^ t a n aa k aa n^
จงมั่นคง	c o ng^ m a n^ kh o ng^
จงรัชตวิบูลย์	c o ng^ r a t^ ch a t a w i b uu n^
จงลักษมณี	c o ng^ l a k^ s a m a n ii
จงวิลาส	c o ng^ w i l aa t^
จงสุทธนามณี	c o ng^ s u t^ th a n aa m a n ii
จงเกษกรณ์	c o ng^ k a s a k @@ n^
จงเลิศเจษฎาวงศ์	c o ng^ l qq t^ c ee t^ s a d aa w o ng^
จงใจพระ	c o ng^ c a j^ phr a
จดจำ	c o t^ c a m^
จตุยศพร	c a t u j o t^ s a ph @@ n^
จตุรภัทรพงษ์	c a t u r a ph a t^ th a r a ph o ng^
จตุรภุช	c a t u r a ph u t^
จนฺทสุวณฺโณ	c o n^ t^ s u w a n oo
จนฺทสโร	c o n^ t^ s a r oo
จนฺทเสฏฺโฐ	c o n^ t^ s ee t^ t^
จนฺทโชติ	c o n^ t^ ch oo t^
จรณวัต	c a r o n^ n a w a t^
จรรยงค์	c a n^ j o ng^
จรรยา	c a n^ j aa
จรรยางค์ดีกุล	c a n^ j aa ng^ d ii k u n^
จรรยาวงษ์	c a n^ j aa w o ng^
จรรย์โกมล	c a n^ k oo m o n^
จรัสบุญประชา	c a r a t^ b u n^ pr a ch aa
จรัสมาส	c a r a t^ m aa t^
จรัสเสถียร	c a r a t^ s a th iia n^
จริงจิตร	c i ng^ c i t^
จริยะเวช	c a r i j a w ee t^
จรุงกิจอนันต์	c a r u ng^ k i t^ z a n a n^
จรุงธรรมโชติ	c a r u ng^ th a m^ m a ch oo t^
จรูญ	c a r uu n^
จวบสมัย	c uua p^ s a m a j^
จองพานิช	c @@ ng^ ph aa n i t^
จอมเกาะ	c @@ m^ k @
จะปะกิยา	c a p a k i j aa
จักกาบาตร์	c a k^ k aa b aa t^
จักขุประสาท	c a k^ kh u pr a s aa t^
จักรพงษ์	c a k^ kr a ph o ng^
จักรพันธุ์	c a k^ kr a ph a n^
จักรยานมวยไทยยิม	c a k^ kr a j aa n^ m uua j^ th a j^ j i m^
จักรสมิทธานนท์	c a k^ kr a s a m i t^ th aa n o n^
จังจรรจา	c a ng^ c a n^ c aa
จันกระจ่าง	c a n^ kr a c aa ng^
จันดากรณ์	c a n^ d aa k @@ n^
จันตาบุญ	c a n^ t a w^ b u n^
จันทคาม	c a n^ th a kh aa m^
จันทนจุลกะ	c a n^ c u n^ l a k a
จันทนะผะลิน	c a n^ th a n a ph a l i n^
จันทนิตย์	c a n^ th a n i t^
จันทน์เสนะ	c a n^ s ee n a
จันทพันธ์	c a n^ th a ph a n^
จันทร	c a n^ th @@ n^
จันทรปาน	c a n^ th a r a p aa n^
จันทรภักดี	c a n^ th @@ n^ ph a k^ d ii
จันทรรวงทอง	c a n^ th a uua ng^ th @@ ng^
จันทรวงศ์	c a n^ th a r a w o ng^
จันทรวิทุร	c a n^ th a r a w i t^ h u r a
จันทรวิบูลย์	c a n^ th a r a w i b uu n^
จันทรศักดิ์	c a n^ th @@ n^ s a k^
จันทรสุรินทร์	c a n^ th a r a s u r i n^
จันทรังษี	c a n^ th a r a n^ s ii
จันทรังษ์	c a n^ th a r a n^ s
จันทรัศมี	c a n^ r a t^ s a m ii
จันทรางศุ	c a n^ th aa r aa ng^ s u
จันทราราชัย	c a n^ thr aa r aa ch a j^
จันทรุเบกษา	c a n^ th a r u b ee k^ s aa
จันทรเวช	c a n^ th a r a w ee t^
จันทรโชติกุล	c a n^ th @@ n^ ch oo t i k u n^
จันทรโสภาคย์	c a n^ th a s oo ph aa k^
จันทร์กระจ่างวงศ์	c a n^ kr a c aa ng^ w o ng^
จันทร์กล่ำ	c a n^ kl a m^
จันทร์จิรา	c a n^ c i r aa
จันทร์ดี	c a n^ d ii
จันทร์ทรัพย์	c a n^ s a p^
จันทร์ประสงค์	c a n^ pr a s o ng^
จันทร์พราหมณ์	c a n^ phr aa m^
จันทร์พิทักษ์	c a n^ ph i th a k^
จันทร์รังสี	c a n^ r a ng^ s ii
จันทร์รุ่ง	c a n^ r u ng^
จันทร์ศรี	c a n^ s ii
จันทร์ศรีสุคต	c a n^ s ii s u kh o t^
จันทร์สมบูรณ์	c a n^ s o m^ b uu n^
จันทร์สว่าง	c a n^ s a w aa ng^
จันทร์สุข	c a n^ s u k^
จันทร์สุวรรณ์	c a n^ s u w a n^
จันทร์เกษ	c a n^ k ee t^
จันทร์เงิน	c a n^ ng qq n^
จันทร์เจริญ	c a n^ c a r qq n^
จันทร์เต็ม	c a n^ t e m^
จันทร์เรือง	c a n^ r vva ng^
จันทร์เสวก	c a n^ s a w ee k^
จันทร์เสี้ยวรัศมี	c a n^ s iia w^ r a t^ s a m ii
จันทร์แก้ว	c a n^ k xx w^
จันทร์แจ่ม	c a n^ c xx m^
จันทร์แดง	c a n^ d xx ng^
จันทร์แป๊ะ	c a n^ p x
จันทร์แสงศรี	c a n^ s xx ng^ s ii
จันทร์โฉม	c a n^ ch oo m^
จันทร์โอชา	c a n^ z oo ch aa
จันทวิมล	c a n^ th a w i m o n^
จันทะยา	c a n^ th a j aa
จันทะวัฒน์	c a n^ th a w a t^
จันทา	c a n^ th aa
จันทิก	c a n^ th i k^
จันทิมาธร	c a n^ th i m aa th @@ n^
จันทุม	c a n^ th u m^
จันทเขตต์	c a n^ th a kh ee t^
จันพุทธ	c a n^ ph u t^
จันษกร	เหนือใต้ c a n^ n a s a k @@ n^
จันเหลือง	c a n^ l vva ng^
จั่นตอง	c a n^ t @@ ng^
จาคอป	c aa kh @@ p^
จาติกวณิช	c aa t i k^ w a n i t^
จาตุกัญญาประทีป	c aa t u k a n^ j aa pr a th ii p^
จาตุรันต์รัศมี	c aa t u r a n^ r a t^ s a m ii
จาตุศรีพิทักษ์	c aa t u s ii ph i th a k^
จามรจันทร์	c aa m @@ n^ c a n^
จามริก	c aa m^ r i k^
จามิกรณ์	c aa m i k @@ n^
จารัตน์	c aa r a t^
จาริกานนท์	c aa r i k aa n o n^
จารุจรณ	c aa r u t^ r o n^
จารุจิตรานนท์	c aa r u c i t^ tr aa n o n^
จารุจินดา	c aa r u c i n^ d aa
จารุธาณินทร์	c aa r u th aa n i n^
จารุนงคราญ	c aa r u n o ng^ khr aa n^
จารุมณี	c aa r u m a n ii
จารุวดีรัตนา	c aa r u w a d ii r a t^ t a n aa
จารุวัฒน์	c aa r u w a t^
จารุสกุล	c aa r u s a k u n^
จารุสมบัติ	c aa r u s o m^ b a t^
จารุเสถียร	c aa r u s a th iia n^
จาละ	c aa l a
จำนง	c a m^ n o ng^
จำปาขาว	c a m^ p aa kh aa w^
จำปาดิบ	c a m^ p aa d i p^
จำปาศรี	c a m^ p aa s ii
จำเกาะ	c a m^ k @
จำเริญ	c a m^ r qq n^
จิตขุนทด	c i t^ t a kh u n^ th o t^
จิตตกุล	c i t^ t a k u n^
จิตตธีรโรจน์	c i t^ t a th ii r a r oo t^
จิตตริยกุล	c i t^ tr i j a k u n^
จิตตรีขันธ์	c i t^ tr ii kh a n^
จิตตลีลา	c i t^ t a l ii l aa
จิตตวีระ	c i t^ t a w ii r a
จิตติเสถียรพร	c i t^ t i s a th iia n^ ph @@ n^
จิตต์กระจ่าง	c i t^ kr a c aa ng^
จิตต์สว่างดี	c i t^ s a w aa ng^ d ii
จิตต์อิสระ	c i t^ z i t^ s a r a
จิตต์แก้วแท้	c i t^ k xx w^ th xx
จิตต์แจ้ง	c i t^ c xx ng^
จิตนิยม	c i t^ n i j o m^
จิตนุกูล	c i t^ t a n u k uu n^
จิตรธรรม	c i t^ tr a th a m^
จิตรพงศ์	c i t^ t a r a ph o ng^
จิตรพึงธรรม	c i t^ ph v ng^ th a m^
จิตรภักดี	c i t^ tr a ph a k^ d ii
จิตรมาส	c i t^ tr a m aa t^
จิตรลดา	c i t^ l a d aa
จิตรสกุล	c i t^ tr a s a k u n^
จิตรสบาย	c i t^ s a b aa j^
จิตรเมืองนนท์	c i t^ tr a m vva ng^ n o n^
จิตร์ระเบียบ	c i t^ r a b iia p^
จิตสวัสดิ์	c i t^ s a w a t^
จิตสัมฤทธิ์	c i t^ s a m^ r i t^
จิตสุทธิภากร	c i t^ s u t^ th i ph aa k @@ n^
จิตฺตคุตฺโต	c i t^ t^ kh u t^ t oo
จินดา	c i n^ d aa
จินดาพล	c i n^ d aa ph o n^
จินดาภู	c i n^ d aa ph uu
จินดารักษ์วงศ์	c i n^ d aa r a k^ w o ng^
จินดาวัฒน์	c i n^ d aa w a t^
จินดาโชติ	c i n^ d aa ch oo t^
จินตกานนท์	c i n^ t a k aa n o n^
จินตนเสรี	c i n^ t a n a s ee r ii
จินตะ	c i n^ t a
จินตะเวช	c i n^ t a w ee t^
จินตโกศล	c i n^ t a k oo s o n^
จินปิ่นเพชร	c i n^ p i n^ ph ee t^
จินะสุยานนท์	c i n a s u j aa n o n^
จินะใจ	c i n a c a j^
จินายน	c i n aa j o n^
จินุพันธ์ุ	c i n u ph a n^ u
จิยะเจริญ	c i j a c a r qq n^
จิรกิติ	c i r a k i t i
จิรชาญชัย	c i r a ch aa n^ ch a j^
จิรปรีชานนท์	c i r a pr ii ch aa n o n^
จิรปุญฺโญ	c i r a p u n^ oo
จิรมณีกุล	c i r a m o n^ ii k u n^
จิรยั่งยืน	c i r a j a ng^ j vv n^
จิรรัชชกิจ	c i r a r a t^ ch a k i t^
จิระพันธุ์วาณิช	c i r a ph a n^ w aa n i t^
จิระศักดิ์	c i r a s a k^
จิรา	c i r aa
จิราธิวัฒน์	c i r aa th i w a t^
จิราโรจน์เจริญ	c i r aa r oo t^ c a r qq n^
จิรเมธากร	c i r a m ee th aa k @@ n^
จิรเวชสุนทรกุล	c i r a w ee t^ ch a s u n^ th @@ r a k u n^
จิรโรจน์	c i r a r oo t^
จิวะกิดาการ	c i w a k i d aa k aa n^
จิวะเกียรติ	c i w a k iia t^
จิวังกูร	c i w a ng^ k uu n^
จิวเฉลิมมิตร	c i w^ ch a l qq m^ m i t^
จีนะวิจารณะ	c ii n a w i c aa r a n a
จีนาคำ	c ii n aa k^ kh a m^
จีรนรภัทร	c ii r a n @@ r a ph a t^
จีรปุญฺโญ	c ii r a p u n^ oo
จีระกุล	c ii r a k u n^
จีระพันธ์	c ii r a ph a n^
จีระมะกร	c ii r a m a k @@ n^
จีระแพทย์	c ii r a ph xx t^
จึงประเสริฐศรี	c v ng^ pr a s qq t^ s ii
จึงรุ่งเรืองกิจ	c v ng^ r u ng^ r vva ng^ k i t^
จึงวิวัฒนวงศ์	c v ng^ w i w a t^ th a n a w o ng^
จึงเจริญสุขยิ่ง	c v ng^ c a r qq n^ s u k^ j i ng^
จึงเลิศศิริ	c v ng^ l qq t^ s i r i
จุฑานนท์	c u th aa n o n^
จุฑานุกาญน์	c u th aa n u k aa n^
จุฑานุกาล	c u th aa n u k aa n^
จุฑาบัณฑิตกุล	c u th aa b a n^ d i t^ k u n^
จุฑามาศ	c u th aa m aa t^
จุฑารัตนกุล	c u th aa r a t^ t a n a k u n^
จุณฑะเกาศลย์	c u n^ th a k a w^ s o n^
จุณณานนท์	c u n^ n aa n o n^
จุติกุล	c u t i k u n^
จุนเกียรติ	c u n^ k iia t^
จุรีมาศ	c u r ii m aa t^
จุลกะเศียน	c u n^ k a s iia n^
จุลพงศธร	c u n^ ph o ng^ s a th @@ n^
จุลรัตนมณี	c u n^ l a r a t^ t a n a m a n ii
จุลละทรัพย์	c u n^ l a l a s a p^
จุลละมณฑล	c u n^ l a l a m o n^ th o n^
จุลละเกศ	c u n^ l a l a k ee t^
จุลลัษเฐียร	c u n^ l a l a t^ iia n^
จุลานนท์	c u l aa n o n^
จุลาสัย	c u l aa s a j^
จุลใส	c u n^ s a j^
จุฬารัตน	c u l aa r a t^
จุ๋ยส์	c u j^
จูจีน	c uu c ii n^
จูประเสริฐ	c uu pr a s qq t^
จูภิบาล	c uu ph i b aa n^
จูแจ้ง	c uu c xx ng^
จ่านกร้อง	c aa n^ k @@ r @@ ng^
จ๊กมก	c o k^ m o k^
จ๊อกกี้ยิม	c @@ k^ k ii j i m^
จ๊ะนะ	c a n a
ฉนฺทสิริ	ch a n t^ s i r i
ฉนฺทสโร	ch a n t^ s a r oo
ฉลาดแฉลม	ch a l aa t^ ch a l xx m^
ฉัตรชัยพลรัตน์	ch a t^ ch a j^ ph o n^ r a t^
ฉัตรทอง	ch a t^ th @@ ng^
ฉัตรบริรักษ์	ch a t^ tr a b @@ r i r a k^
ฉัตรมาลีรัตน์	ch a t^ m aa l ii r a t^
ฉัตรวิชัย	ch a t^ w i ch a j^
ฉัตรวิไล	ch a t^ w i l a j^
ฉันทศาสตร์โกศล	ch a n^ th a s aa t^ k oo s o n^
ฉายทองดี	ch aa j^ th @@ ng^ d ii
ฉายรัศมี	ch aa j^ r a t^ s a m ii
ฉายสุวรรณ	ch aa j^ s u w a n^
ฉายะจินดา	ch aa j a c i n^ d aa
ฉายัษเฐียร	ch aa j a t^ iia n^
ฉายางาม	ch aa j aa ng aa m^
ฉายาพันธุ์	ch aa j aa ph a n^
ฉายแสง	ch aa j^ s xx ng^
ฉิมทะเล	ch i m^ th a l ee
ฉิมท้วม	ch i m^ th uua m^
ฉิมบรรจง	ch i m^ b a n^ c o ng^
ฉิมประเสริฐ	ch i m^ pr a s qq t^
ฉ่ำรัศมี	ch a m^ r a t^ s a m ii
ชนะจิต	ch a n a c i t^
ชนะชัยสุวรรณ	ch a n a ch a j^ s u w a n^
ชนะภัย	ch a n a ph a j^
ชนะวงศ์	ch a n a w o ng^
ชมชืนดี	ch o m^ ch vv n^ d ii
ชมชื่นดี	ch o m^ ch vv n^ d ii
ชมประสพ	ch o m^ pr a s o p^
ชมพูพวง	ch o m^ ph uu ph uua ng^
ชมภูเทพ	ch o m^ ph uu th ee p^
ชมภูแดง	ch o m^ ph uu d xx ng^
ชมะนันทน์	ch a m a n a n^
ชยนนท์	ch a j^ n o n^
ชยุติ	ch a j u t i
ชลดา	ch o n^ l a d aa
ชลธาร์นนท์	ch o n^ l a th aa n o n^
ชลธิชา	ch o n^ th i ch aa
ชลภูมิ	ch o n^ l a ph uu m^
ชลมูณี	ch o n^ m uu n ii
ชลวิจารณ์	ch o n^ w i c aa n^
ชลศรานนท์	ch o n^ l a s a r aa n o n^
ชลหวรรณ	ch o n^ l a w a n^
ชลออยู่	ch o n^ z j uu
ชลากร	ch a l aa k @@ n^
ชลาชล	ch a l aa ch o n^
ชลายนคุปต์	ch a l aa j a n a kh u p^
ชลารักษ์	ch a l aa r a k^
ชวกิจกาญจน์	ch a w a k i t^ c a k aa n^
ชวกุล	ch a w a k u n^
ชวนชื่น	ch uua n^ ch vv n^
ชวนบุญ	ch uua n^ b u n^
ชวนะวิรัช	ch a w a n a w i r a t^
ชวยบุญชุม	ch uua j^ b u n^ ch u m^
ชวาลตันพิพัทธ์	ch a w aa n^ t a n^ ph i ph a t^
ชวูเลร่า	ch a w uu l ee r aa
ชอบชื่นชม	ch @@ p^ ch vv n^ ch o m^
ชอบประดิถ	ch @@ p^ pr a d i t^
ชอบแต่ง	ch @@ p^ t xx ng^
ชะชะช่า	ch a ch a ch aa
ชะนะกุล	ch a n a k u n^
ชะนะชาญ	ch a n a ch aa n^
ชะนะบุตร	ch a n a b u t^
ชะเอม	ch a z ee m^
ชัชวาลพงศ์พันธ์	ch a t^ ch a w aa n^ ph o ng^ ph a n^
ชัชวาลโชติกุล	ch a t^ ch a w aa n^ ch oo t i k u n^
ชันซื่อ	ch a n^ s vv
ชันแสง	ch a n^ s xx ng^
ชับปุยส์	ch a p^ p u j^
ชัยกิจเด่นนภาลัย	ch a j^ k i t^ d e n^ n a ph aa l a j^
ชัยคำดี	ch a j^ kh a m^ d ii
ชัยจันทร์	ch a j^ j a c a n^
ชัยจิตวณิชกุล	ch a j^ j a c i t^ t a w a n i t^ ch a k u n^
ชัยจินดา	ch a j^ j a c i n^ d aa
ชัยชิตาทร	ch a j^ ch i t aa th @@ n^
ชัยณรงค์สิงห์	ch a j^ n a r o ng^ s i ng^
ชัยนาม	ch a j^ n aa m^
ชัยบัญชา	ch a j^ b a n^ ch aa
ชัยประวิตร	ch a j^ j a pr a w i t^
ชัยประสิทธิ์	ch a j^ pr a s i t^
ชัยประเสริฐ	ch a j^ j a pr a s qq t^
ชัยภูมิ	ch a j^ j a ph uu m^
ชัยรัตน์	ch a j^ r a t^
ชัยรุ่งเรือง	ch a j^ r u ng^ r vva ng^
ชัยวิชิต	ch a j^ w i ch i t^
ชัยวินิตย์	ch a j^ w i n i t^
ชัยวิรัตนะ	ch a j^ w i r a t^ t a n a
ชัยศรศรายุทธ	ch a j^ s @@ n^ s a r aa j u t^
ชัยสงคราม	ch a j^ s o ng^ khr aa m^
ชัยอนันต์	ch a j^ z a n a n^
ชัยอรรถ	ch a j^ z a t^
ชัยเจริญ	ch a j^ c a r qq n^
ชัยเฉลิมพล	ch a j^ ch a l qq m^ ph o n^
ชัยเชาวรัตน์	ch a j^ ch a w^ w a r a t^
ชัยเสรี	ch a j^ s ee r ii
ชัยแป้น	ch a j^ p x n^
ชาชุมพร	ch aa ch u m^ ph @@ n^
ชาญนุกูล	ch aa n^ n u k uu n^
ชาญพานิชย์	ch aa n^ ph aa n i t^
ชาญมนูญ	ch aa n^ m a n uu n^
ชาญวีรกูล	ch aa n^ w ii r a k uu n^
ชาญเฉลิม	ch aa n^ ch a l qq m^
ชาญเชิงศิลปกุล	ch aa n^ ch qq ng^ s i n^ l a p a k u n^
ชาญเลขา	ch aa n^ l ee kh aa
ชาตรี	ch aa tr ii
ชาตะเมธีกุล	ch aa t a m ee th ii k u n^
ชาติบัณฑิต	ch aa t^ t i b a n^ d i t^
ชาติพงษ์	ch aa t^ ph o ng^
ชาติมนตรี	ch aa t^ t i m o n^ tr ii
ชาติวันชัย	ch aa t^ t i w a n^ ch a j^
ชาติสุวรรณ	ch aa t^ s u w a n^
ชาทอง	ch aa th @@ ng^
ชาทุม	ch aa th u m^
ชานี	ch aa n ii
ชามพูนท	ch aa m^ ph uu n o t^
ชายด่าน	ch aa j^ d aa n^
ชารีฟสกุล	ch a r ii f^ s a k u n^
ชาลีกุล	ch aa l ii k u n^
ชาลีจันทร์	ch aa l ii c a n^
ชาลีผาย	ch aa l ii ph aa j^
ชาลีเครือ	ch aa l ii khr vva
ชาวงษ์	ch aa w o ng^
ชาวทองหลาง	ch aa w^ th @@ ng^ l aa ng^
ชาวเขา	ch aa w^ kh a w^
ชาวเชียงขวาง	ch aa w^ ch iia ng^ khw aa ng^
ชาสังข์	ch aa s a ng^
ชาเตอร์	ch aa t qq
ชำนาญยา	ch a m^ n aa n^ j aa
ชำนาญเวช	ch a m^ n aa n^ w ee t^
ชำนิประศาสน์	ch a m^ n i pr a s aa t^
ชิงร้อยชิงล้าน	ch i ng^ r @@ j^ ch i ng^ l aa n^
ชิดชอบ	ch i t^ ch @@ p^
ชิตพงศ์	ch i t^ t a ph o ng^
ชิตมณี	ch i t^ t a m a n ii
ชินจินดา	ch i n^ c i n^ d aa
ชินนภาแสน	ch i n^ n a ph aa s xx n^
ชินพันธุ์	ch i n^ n a ph a n^
ชินวงศ์	ch i n^ w o ng^
ชินวัตร	ch i n^ w a t^
ชินวินิจกุล	ch i n^ n a w i n i t^ k u n^
ชินสี	ch i n^ n a s ii
ชิวารักษ์	ch i w aa r a k^
ชีพชาญเดช	ch ii p^ ph a ch aa n^ d ee t^
ชีรวินิจ	ch ii r a w i n i t^
ชีวการุณ	ch ii w a k aa r u n^
ชีวนิชพันธ์	ch ii w a n i t^ ch a ph a n^
ชีวอารี	ch ii w a z aa r ii
ชีวานันท์	ch ii w aa n a n^
ชีโร่	ch ii r oo
ชื่นชมบูรณ์	ch vv n^ ch o m^ b uu n^
ชื่นชูผล	ch vv n^ ch uu ph o n^
ชื่นตา	ch vv n^ t aa
ชื่นประดิษฐ์	ch vv n^ pr a d i t^
ชื่นประโยชน์	ch vv n^ pr a j oo t^
ชื่นวิทยา	ch vv n^ w i t^ th a j aa
ชื่นหิรัญ	ch vv n^ h i r a n^
ชื่นเย็น	ch vv n^ j e n^
ชุณหวัตร	ch u n^ h a w a t^
ชุณหสวัสดิกุล	ch u n^ h a s a w a t^ d i k u n^
ชุณหะวงศ์วสุ	ch u n^ h a w o ng^ w a s u
ชุณหะวัณ	ch u n^ h a w a n^
ชุติกุล	ch u t i k u n^
ชุติวรรณโสภณ	ch u t i w a n^ s oo ph o n^
ชุมชัยเวทย์	ch u m^ ch a j^ w ee t^
ชุมดวง	ch u m^ d uua ng^
ชุมทวียศ	ch u m^ th a w ii j o t^
ชุมพล	ch u m^ ph o n^
ชุมมะ	ch u m^ m a
ชุมสาย	ch u m^ s aa j^
ชุ่มคำ	ch u m^ kh a m^
ชุ่มภาณี	ch u m^ ph aa n ii
ชูกล่อม	ch uu kl @ m^
ชูกิจ	ch uu k i t^
ชูชิน	ch uu ch i n^
ชูชื่น	ch uu ch vv n^
ชูทอง	ch uu th @@ ng^
ชูนวลศรี	ch uu n uua n^ s ii
ชูบัว	ch uu b uua
ชูประทุม	ch uu pr a th u m^
ชูพินิจ	ch uu ph i n i t^
ชูมีชัย	ch uu m ii ch a j^
ชูลาภ	ch uu l aa p^
ชูวงษ์	ch uu w o ng^
ชูวัฒนะ	ch uu w a t^ th a n a
ชูศรี	ch uu s ii
ชูศักดิ์สกุลวิบูล	ch uu s a k^ s a k u n^ w i b uu n^
ชูสกุล	ch uu s a k u n^
ชูเชิดกีรติวัฒน์	ch uu ch qq t^ k ii r a t i w a t^
ชูเชิดรัตนา	ch uu ch qq t^ r a t^ t a n aa
ชูเดช	ch uu d ee t^
ชูเพ็ชร์	ch uu ph e t^
ชูเมืองกุศล	ch uu m vva ng^ k u s o n^
ชูเอ็ทท์	ch uu z e t^
ชโยวรรณ	ch a j oo w a n^
ช็อคกิ้งพิ้งค์	ch @ k^ k i ng^ ph i ng^
ช่วยปลอด	ch uua j^ pl @@ t^
ช่วยเกิด	ch uua j^ k qq t^
ช่วยเกื้อ	ch uua j^ k vva
ช่อชะมวง	ch @@ ch a m uua ng^
ช่อชูวงศ์	ch @@ ch uu w o ng^
ช่างกลึงเหมาะ	ch a ng^ kl v ng^ m @
ช่างปรุง	ch a ng^ pr u ng^
ช่างปลูก	ch aa ng^ pl uu k^
ช่างพินิจ	ch a ng^ ph i n i t^
ช่างหล่อ	ch a ng^ l @@
ช้างทอง	ch aa ng^ th @@ ng^
ช้างมงคล	ch aa ng^ m o ng^ kh o n^
ช้างเขียว	ch aa ng^ kh iia w^
ช้างเสวก	ch aa ng^ s a w ee k^
ซองทอง	s @@ ng^ th @@ ng^
ซอสูงเนิน	s @@ s uu ng^ n qq n^
ซารัมย์	s aa r a m^
ซาโนลารี่	s aa n oo l aa r ii
ซำทองไหล	s a m^ th @@ ng^ l a j^
ซำมะกุล	s a m^ m a k u n^
ซิงห์	s i ng^
ซิลลา	s i n^ l aa
ซีกฮาร์ท	s ii k^ h aa t^
ซีพียิม	s ii ph ii j i m^
ซีพียิมส์	s ii ph ii j i m^
ซีพีเฟรชมาร์ท	s ii ph ii fr ee t^ m aa t^
ซื่อสัตย์	s vv s a t^
ซูสารอ	s uu s aa r @@
ซ่าอินทร์	s aa z i n^
ซ้อนขำ	s @@ n^ kh a m^
ซ้ายขวัญ	s aa j^ khw a n^
ญาติเยอะ	j aa t^ j q
ฐานวิเศษ	th aa n^ w i s ee t^
ฐานะจาโร	th aa n a c aa r oo
ฐานิตย์	th aa n i t^
ฐิตะกวิน	th i t a k a w i n^
ฐิตะวชิระ	th i t a w a ch i r a
ฐิติธนการ	th i t i th a n a k aa n^
ฐิติมัชฌิมา	th i t i m a t^ ch i m aa
ณรงค์ฤทธิ์	n a r o ng^ r i t^
ณศีลวันต์	n a s ii n^ l a w a n^
ณะศรี	n a s ii
ณีนา	n ii n aa
ดนัยตั้งตระกูล	d a n a j^ t a ng^ tr a k uu n^
ดลมินทร์	d o n^ m i n^
ดวงจันทร์	d uua ng^ c a n^
ดวงพร	d uua ng^ ph @@ n^
ดวงพลา	d uua ng^ phl aa
ดวงพิกุล	d uua ng^ ph i k u n^
ดวงมณีรัตนชัย	d uua ng^ m a n ii r a t^ t a n a ch a j^
ดวงรัตนตรัย	d uua ng^ r a t^ t a n a tr a j^
ดวงสุวรรณ์	d uua ng^ s u w a n^
ดอกกระโดน	d @@ k^ kr a d oo n^
ดอกกะฐิน	d @@ k^ k a th i n^
ดอกประดู่	d @@ k^ pr a d uu
ดอกมะดัน	d @@ k^ m a d a n^
ดอกมะลิป่า	d @@ k^ m a l i p aa
ดอกสะเดา	d @@ k^ s a d a w^
ดอกเทียน	d @@ k^ th iia n^
ดอกไม้คลี่	d @@ k^ m aa j^ khl ii
ดอกไม้แก้ว	d @@ k^ m aa j^ k xx w^
ดอนประดิษฐ์	d @@ n^ pr a d i t^
ดอนเจดีย์	d @@ n^ c ee d ii
ดอมไธสง	d @@ m^ th a j^ s o ng^
ดอเลาะ	d @@ l @
ดะห์ลัน	d a l a n^
ดังวัธนาวณิชย์	d a ng^ w a t^ th a n aa w a n i t^
ดัชนี	d a t^ ch a n ii
ดัทซ์บอยยิม	d a t^ b @ j^ j i m^
ดันดี	d a n^ d ii
ดัสกร	d a t^ s a k @@ n^
ดั่งวัน	d a ng^ w a n^
ดานุวงศ์	d aa n u w o ng^
ดาบธรรม	d aa p^ th a m^
ดามาพงศ์	d aa m aa ph o ng^
ดาระดาษ	d aa a d aa t^
ดารา	d aa r aa
ดารากานต์	d aa r aa k aa n^
ดาราน้อย	d aa r aa n @@ j^
ดารินทร์	d aa r i n^
ดาวฉาย	d aa w^ ch aa j^
ดาวสว่าง	d aa w^ s a w aa ng^
ดาวสุพรรณ	d aa w^ s u ph a n^
ดาวอุดร	d aa w^ z u d @@ n^
ดาวเรือง	d aa w^ r vva ng^
ดาเกลี้ยง	d aa kl iia ng^
ดำดี	d a m^ d ii
ดำรงค์ศักดิ์กุล	d a m^ r o ng^ s a k^ k u n^
ดำรงค์อ่องตระกูล	d a m^ r o ng^ z @ ng^ tr a k uu n^
ดำรงชัยธรรม	d a m^ r o ng^ ch a j^ th a m^
ดำรงรัตน์	d a m^ r o ng^ r a t^
ดำรงหัด	d a m^ r o ng^ h a t^
ดำรงเจริญ	d a m^ r o ng^ c a r qq n^
ดำเนิน	d a m^ n qq n^
ดิถียนต์	d i th ii j o n^
ดิถีเพ็ญ	d i th ii ph e n^
ดินเขต	d i n^ kh ee t^
ดิลกวณิช	d i l o k^ w a n i t^
ดิศกุล	d i t^ k u n^
ดิษฐาอภิชัย	d i t^ th aa z a ph i ch a j^
ดิษยบุตร	d i t^ s a j a b u t^
ดิษยะศริน	d i t^ s a j a s a r i n^
ดีคาบาเลส	d ii kh aa b aa l ee t^
ดีดีดี	d ii d ii d ii
ดีนาน	d ii n aa n^
ดีประเสริฐ	d ii pr a s qq t^
ดีพร้อม	d ii phr @@ m^
ดีพัฒนบูลย์	d ii ph a t^ th a n a b uu n^
ดีรัศมี	d ii r a t^ s a m ii
ดีล่า	d ii l aa
ดีสมเลิศ	d ii s o m^ l qq t^
ดีสวัสดิ์	d ii s a w a t^
ดีสาย	d ii s aa j^
ดีเทศน์	d ii th ee t^
ดีเสมอ	d ii s a m qq
ดีแลน	d ii l xx n^
ดุรงค์เดช	d u r o ng^ d ee t^
ดุริยประณีต	d u r i j a pr a n ii t^
ดุลยวิจิตร	d u n^ j a w i c i t^
ดุลยา	d u n^ l a j aa
ดุษฎีสุรพจน์	d u t^ s a d ii s u r a ph o t^
ด่านขุนทด	d aa n^ kh u n^ th o t^
ด่านชัยวิจิตร	d aa n^ ch a j^ w i c i t^
ด่านบวรเกียรติ	d aa n^ b @@ z^0 w @@ n^ k iia t^
ด่านวัฒนานุสรณ์	d aa n^ w a t^ th a n aa n u s @@ n^
ด่านอุดม	d aa n^ z u d o m^
ด่านไพบูลย์	d aa n^ ph a j^ b uu n^
ด้วงชะอุ่ม	d uua ng^ ch a z u m^
ด้วยเศียรเกล้า	d uua j^ s iia n^ kl a w^
ตงศิริ	t o ng^ s i r i
ตงสาลี	t o ng^ s aa l ii
ตมิศานนท์	t a m i s aa n o n^
ตรงเจริญชัยกุล	tr o ng^ c a r qq n^ ch a j^ k u n^
ตระกูลราษฎร์	tr a k uu n^ r aa t^
ตระกูลเผด็จไกร	tr a k uu n^ ph a d e t^ kr a j^
ตรังเจริญงาม	tr a ng^ c a r qq n^ ng aa m^
ตราโมท	tr aa m oo t^
ตริยะกุล	tr i j a k u n^
ตริยานนท์	tr i j aa n o n^
ตรีจักรสังข์	tr ii c a k^ s a ng^
ตรีชัยยะ	tr ii ch a j^ j a
ตรีทอง	tr ii th @@ ng^
ตรีธารา	tr ii th aa r aa
ตรีบุปผา	tr ii b u p^ ph aa
ตรีรัตนวารีสิน	tr ii r a t^ t a n a w aa r ii s i n^
ตรีวิมล	tr ii w i m o n^
ตรีสิริเกษม	tr ii s i r i k a s ee m^
ตรีสุขี	tr ii s u kh ii
ตรีเดช	tr ii d ee t^
ตฤณขจี	tr i n^ n a kh a c ii
ตวนกู	t uua n^ k uu
ตวันพงค์	t a w a n^ ph o ng^
ตังคณานุรักษ์	t a ng^ kh a n aa n u r a k^
ตังค์สุรัตน์	t a ng^ s u r a t^
ตังทัตสวัสดิ์	t a ng^ th a t^ s a w a t^
ตังสุรัตน์	t a ng^ s u r a t^
ตัณฑปุตตะ	t a n^ th a p u t^ t a
ตัณฑสิทธิ์	t a n^ th a s i t^
ตัณฑะสุวรรณะ	t a n^ th a s u w a n^ n a
ตัณฑะเตมีย์	t a n^ th a t ee m ii
ตัณฑเศรษฐี	s ee t^ th ii
ตัณฑเสถียร	t a n^ th a s a th iia n^
ตันจรารักษ์	t a n^ c aa r a k^
ตันฑ์ศรีสุโรจน์	t a n^ s ii s u r oo t^
ตันตระกูล	t a n^ tr a k uu n^
ตันตระเสนีย์	t a n^ tr a s ee n ii
ตันตรานนท์	t a n^ tr aa n o n^
ตันตรามาตย์	t a n^ tr aa m aa t^
ตันติชินานนท์	t a n^ t i ch i n aa n o n^
ตันติประสงค์ชัย	t a n^ t i pr a s o ng^ ch a j^
ตันติประสุต	t a n^ t i pr a s u t^
ตันติพงศ์	t a n^ t i ph o ng^
ตันติพิภพ	t a n^ t i ph i ph o p^
ตันติภนา	t a n^ t i ph a n aa
ตันติมนตรี	t a n^ t i m o n^ tr ii
ตันติยาพงศ์	t a n^ t i j aa ph o ng^
ตันติรุ่งโรจน์ชัย	t a n^ t i r u ng^ r oo t^ ch a j^
ตันติวัฒนทรัพย์	t a n^ t i w a t^ th a n a s a p^
ตันติวิทยาพิทักษ์	t a n^ t i w i t^ th a j aa ph i th a k^
ตันติวุฒิ	t a n^ t i w u t^
ตันติศิรินทร์	t a n^ t i s i r i n^
ตันติสุข	t a n^ t i s u k^
ตันติสุนทร	t a n^ t i s u n^ th @@ n^
ตันติเมธ	t a n^ t i m ee t^
ตันติเวชกุล	t a n^ t i w ee t^ ch a k u n^
ตันทา	t a n^ th aa
ตันธนะศิริวงศ์	t a n^ th a n a s i r i w o ng^
ตันบรรจง	t a n^ b a n^ c o ng^
ตันประเสริฐ	t a n^ pr a s qq t^
ตันศิริ	t a n^ s i r i
ตันสมบูรณ์	t a n^ s o m^ b uu n^
ตันสุหัช	t a n^ s u h a t^
ตันเจริญ	t a n^ c a r qq n^
ตันเถียร	t a n^ th iia n^
ตันไพเราะห์	t a n^ ph a j^ r @
ตั้งนพกุล	t a ng^ n o p^ ph a k u n^
ตั้งบริบูรณ์รัตน์	t a ng^ b @@ r i b uu n^ r a t^
ตั้งปณิธานนท์	t a ng^ p a n i th aa n o n^
ตั้งประภาพร	t a ng^ pr a ph aa ph @@ n^
ตั้งพงษ์	t a ng^ ph o ng^
ตั้งภากรณ์	t a ng^ ph aa k @@ n^
ตั้งศรีสุข	t a ng^ s ii s u k^
ตั้งศักดิ์ยืน	t a ng^ s a k^ j vv n^
ตั้งศุภกุล	t a ng^ s u p^ ph a k u n^
ตั้งสวัสดิ์รัตน์	t a ng^ s a w a t^ r a t^
ตั้งอนุรัตน์	t a ng^ z a n u r a t^
ตั้งเจริญถาวร	t a ng^ c a r qq n^ th aa w @@ n^
ตั๋ง	t ng^
ตาปลา	t aa pl aa
ตามไท	t aa m^ th a j^
ตาระพัน	t aa r a ph a n^
ตาลปุตฺโต	t aa l a p u t^ t oo
ติงศภัทิย์	t i ng^ s a ph a t^
ติงสัญชลี	t i ng^ s a n^ ch a l ii
ติณรัตน์	t i n^ r a t^
ติณสูลานนท์	t i n^ s uu l aa n o n^
ติธรรม	t i th a m^
ติปยานนท์	t i p a j aa n o n^
ติยะกร	t i j a k @@ n^
ติยะไพรัช	t i j a ph a j^ r a t^
ติยายน	t i j aa j o n^
ติละพรพัฒน์	t i l a phr a ph a t^
ติ้วสุวรรณ	t i w^ s u w a n^
ตีกาสม	t ii k aa s o m^
ตีบนอก	t ii p^ n @@ k^
ตีรสวัสดิชัย	t ii r a s a w a t^ d i ch a j^
ตีระวนิช	t ii r a w a n i t^
ตุรงคกุล	t u r o ng^ kh a k u n^
ตุลยฉัตร	t u n^ j a ch a t^
ตุลารักษ์	t u l aa r a k^
ตุ่นแก้ว	t u n^ k xx w^
ตุ้นทัพไทย	t u n^ th a p^ th a j^
ตู้จินดา	t uu c i n^ d aa
ต่างใจ	t aa ng^ c a j^
ต่ายทอง	t aa j^ th @@ ng^
ต้นกันยา	t o n^ k a n^ j aa
ต้นคำ	t o n^ kh a m^
ต้วมสูงเนิน	t uua m^ s uu ng^ n qq n^
ต้อมคำ	t @@ m^ kh a m^
ถนอมบุญ	th a n @@ m^ b u n^
ถนอมรอด	th a n @@ m^ r @@ t^
ถนอมเมือง	th a n @@ m^ m vva ng^
ถมมา	th o m^ m aa
ถมยา	th o m^ j aa
ถาคำฟู	th aa kh a m^ f uu
ถามะพันธ์	th aa m a ph a n^
ถาวรบุตร	th aa w @@ n^ b u t^
ถาวรวงศ์	th aa w @@ n^ w o ng^
ถาวรศักดิ์	th aa w @@ n^ s a k^
ถาวราภา	th aa w a r aa ph aa
ถาวรเจริญ	th aa w @@ n^ c a r qq n^
ถาวรเศรษฐ	th aa w @@ r a s ee t^
ถาวโร	th aa w a r oo
ถินขาว	th i n^ kh aa w^
ถิรพงศ์ไพบูลย์	th i r a ph o ng^ ph a j^ b uu n^
ถิ่นจอม	th i n^ c @@ m^
ทนาวิวัฒน์	th a n aa w i w a t^
ทนฺตมโน	th o n^ t a m a n oo
ทมพา	th o m^ ph aa
ทรงกิตรัตน์	s o ng^ k i t^ r a t^
ทรงคำ	s o ng^ kh a m^
ทรงงามทรัพย์	s o ng^ ng aa m^ s a p^
ทรงประเสริฐ	s o ng^ pr a s qq t^
ทรงพล	s o ng^ ph o n^
ทรงศรี	s o ng^ s ii
ทรงเผ่า	s o ng^ ph a w^
ทรงแสง	s o ng^ s xx ng^
ทรนง	th @@ r a n o ng^
ทรัพย์กุลชนนาถ	s a p^ k u n^ l a ch o n^ n a n aa t^
ทรัพย์นิรันดร์	s a p^ n i r a n^
ทรัพย์วิจิตร	s a p^ w i c i t^
ทรัพย์สุนทร	s a p^ s u n^ th @@ n^
ทรัพย์เพิ่ม	s a p^ ph qq m^
ทรัพย์เสริมศรี	s a p^ s qq m^ s ii
ทรัพย์แสนยากร	s a p^ s a n xx j aa k @@ n^
ทวนยก	th uua n^ j o k^
ทวินส์ยิม	th a w i n^ j i m^
ทวีกาญจน์	th a w ii k aa n^
ทวีกุล	th a w ii k u n^
ทวีกุลกาญจน์	th a w ii k u n^ k aa n^
ทวีปถาวรวงศ์	th a w ii p^ th aa w @@ n^ w o ng^
ทวีผล	th a w ii ph o n^
ทวียนต์ชัย	th a w ii j o n^ ch a j^
ทวีสิน	th a w ii s i n^
ทวีเฉลิมดิษฐ์	th a w ii ch a l qq m^ d i t^
ทศพร	th o t^ s a ph @@ n^
ทศพล	th o t^ s a ph o n^
ทศไกร	th o t^ kr a j^
ทองกองทุน	th @@ ng^ k @@ ng^ th u n^
ทองคำ	th @@ ng^ kh a m^
ทองคำชู	th @@ ng^ kh a m^ ch uu
ทองจินดา	th @@ ng^ c i n^ d aa
ทองจิลา	th @@ ng^ c i l aa
ทองชิตร	th @@ ng^ ch i t^
ทองชิว	th @@ ng^ ch i w^
ทองดี	th @@ ng^ d ii
ทองตัน	th @@ ng^ t a n^
ทองธรรมชาติ	th @@ ng^ th a m^ m a ch aa t^
ทองธิราช	th @@ ng^ th i r aa t^
ทองน่วม	th @@ ng^ n uua m^
ทองบริสุทธิ์	th @@ ng^ br b @@ r i s u t^
ทองบุญเรือง	th @@ ng^ b u n^ r vva ng^
ทองบุราณ	th @@ ng^ b u r aa n a
ทองประยูร	th @@ ng^ pr a j uu n^
ทองประสม	th @@ ng^ pr a s o m^
ทองประเสริฐ	th @@ ng^ pr a s qq t^
ทองปาน	th @@ ng^ p aa n^
ทองพลับ	th @@ ng^ phl a p^
ทองพันชั่ง	th @@ ng^ ph a n^ ch a ng^
ทองภักดี	th @@ ng^ ph a k^ d ii
ทองลงยา	th @@ ng^ l o ng^ j aa
ทองลั่นธม	th @@ ng^ l a n^ th o m^
ทองวัฒนา	th @@ ng^ w a t^ th a n aa
ทองวิเศษ	th @@ ng^ w i s ee t^
ทองศรี	th @@ ng^ s ii
ทองสงค์	th @@ ng^ s o ng^
ทองสมัคร	th @@ ng^ s a m a k^
ทองสวัสดิ์	th @@ ng^ s a w a t^
ทองสอง	th @@ ng^ s @@ ng^
ทองสาริ	th @@ ng^ s aa r i
ทองสินธุ์	th @@ ng^ s i n^
ทองสิริไพรศรี	th @@ ng^ s i r i ph a j^ r a s ii
ทองสุก	th @@ ng^ s u k^
ทองสุขแก้ว	th @@ ng^ s u k^ k xx w^
ทองหยวก	th @@ ng^ j uua k^
ทองอยู่ยง	th @@ ng^ j uu j o ng^
ทองเกล็ด	th @@ ng^ kl e t^
ทองเจือ	th @@ ng^ c vva
ทองเดช	th @@ ng^ d ee t^
ทองเดชศรี	th @@ ng^ d ee t^ s ii
ทองเทพ	th @@ ng^ th ee p^
ทองเปาด์	th @@ ng^ p a j^
ทองเสน	th @@ ng^ s ee n^
ทองเหลา	th @@ ng^ l a w^
ทองเหล็ง	th @@ ng^ l e ng^
ทองแถม	th @@ ng^ th xx m^
ทองแท้	th @@ ng^ th xx
ทองแสง	th @@ ng^ s xx ng^
ทองโรจน์	th @@ ng^ r oo t^
ทองใจ	th @@ ng^ c a j^
ทองใจสด	th @@ ng^ c a j^ s o t^
ทองใหญ่	th @@ ng^ j a j^
ทองไทย	th @@ ng^ th a j^
ทองไล้	th @@ ng^ l a j^
ทอมสัน	th @@ m^ s a n^
ทอย	th @@ j^
ทะสา	th a s aa
ทักราล	th a k^ r aa n^
ทักษิณอีสาน	th a k^ s i n^ z ii s aa n^
ทัคเกอร์	th a k^ k qq
ทังโส	th a ng^ s oo
ทัดพิทักษ์กุล	th a t^ ph i th a k^ k u n^
ทับทิม	th a p^ th i m^
ทับทิมใส	th a p^ th i m^ s a j^
ทับวัง	th a p^ w a ng^
ทับสุวรรณ	th a p^ s u w a n^
ทับแก้ว	th a p^ k xx w^
ทัพคัลไลย	th a p^ kh a n^ l a j^
ทัพพะรังสี	th a p^ ph a r a ng^ s ii
ทัพมงคล	th a p^ ph a m o ng^ kh o n^
ทัพวิเศษ	th a p^ w i s ee t^
ทัศนพันธ์	th a t^ s a n a ph a n^
ทัศนาญชลี	th a t^ s a n aa n^ ch a l ii
ทั่งทอง	th a ng^ th @@ ng^
ทาทอง	th aa th @@ ng^
ทานา	th aa n aa
ทำประโยชน์	th a m^ pr a j oo t^
ทำว่อง	th a m^ w @ ng^
ทิฆัมพรธีรวงศ์	th i kh a m^ ph @@ n^ th ii r a w o ng^
ทิพกนก	th i k a n o k^
ทิพยมณฑล	th i p^ ph a j a m o n^ th o n^
ทิพย์มณี	th i p^ m a n ii
ทิพย์วังค์	th i p^ ph a w a ng^
ทิพา	th i ph aa
ทิพโกมุท	th i p^ ph a k oo m u t^
ทิมกุล	th i m^ k u n^
ทิมดี	th i m^ d ii
ทิมสุวรรณ	th i m^ s u w a n^
ทิวารี	th i w aa r ii
ทิวไผ่งาม	th i w^ ph a j^ ng aa m^
ทิสุด	th i s u t^
ทีฆะตระกูล	th ii kh a tr a k uu n^
ทีปประสาน	th ii p a pr a s aa n^
ทีปสุวรรณ	th ii p^ s u w a n^
ทีปะนาถ	th ii p a n aa t^
ทีปิรัช	th ii p i r a t^
ทุ่งทอง	th u ng^ th @@ ng^
ทุ่งทองคำ	th u ng^ th @@ ng^ kh a m^
ท้าวคำลือ	th aa w^ kh a m^ l vv
ธงไชย	th o ng^ ch a j^
ธนกิตติ์ธนานนท์	th a n a k i t^ th a n aa n o n^
ธนชาต	th a n a ch aa t^
ธนธีรธรรม	th a n a th ii r a th a m^
ธนบุญชัย	th a n a b u n^ ch a j^
ธนบุรีฟาร์ม	th o n^ b u r ii f aa m^
ธนพัฒน์พิศาล	th a n a ph a t^ ph i s aa n^
ธนพิชชากรณ์	th a n a ph i t^ ch aa k @@ n^
ธนภรรคภวิน	th a n a ph a k^ ph a w i n^
ธนภัทร	th a n a ph a t^
ธนวัฒน์	th a n a w a t^
ธนศรีวนิชชัย	th a n a s ii w a n i t^ ch a j^
ธนสงวนวงศ์	th a n a s a ng uua n^ w o ng^
ธนสาร	th a n a s aa n^
ธนสุกาญจน์	th o n^ s u k aa j o t^
ธนสุนทร	th a n a s u n^ th @@ n^
ธนะพัฒน์	th a n a ph a t^
ธนะภูมิ	th a n a ph uu m^
ธนะรัชต์	th a n a r a t^
ธนะวิทวิลาศ	th a n a w i t^ w i l aa t^
ธนะสิริ	th a n a s i r i
ธนะเสวี	th a n a s ee w ii
ธนันต์ชัยกานต์	th a n a n^ ch a j^ k aa n^
ธนันทา	th a n a n^ th aa
ธนากร	th a n aa k @@ n^
ธนาคมานุสรณ์	th a n aa kh a m aa n u s @@ n^
ธนาดิเรก	th a n aa d i r ee k^
ธนาอัมพุช	th a n aa z a m^ ph u t^
ธนิกุล	th a n i k u n^
ธนูพราน	th a n uu phr aa n^
ธนเศวต	th a n a s a w ee t^
ธนเสนีวัฒน์	th a n a s ee n ii w a t^
ธมฺมโชโต	th a m m^ ch oo t oo
ธยานศิลป์	th a j aa n a s i n^
ธรณินทร์	th @@ r a n i n^
ธรรมกามี	th a m^ m a k aa m ii
ธรรมดา	th a m^ m a d aa
ธรรมทัต	th a m^ m a th a t^
ธรรมธิ	th a m^ m a th i
ธรรมนาม	th a m^ m a n aa m^
ธรรมปรีชา	th a m^ m a pr ii ch aa
ธรรมปรีดานันท์	th a m^ m a pr ii d aa n a n^
ธรรมมล	th a m^ m a m o n^
ธรรมยศ	th a m^ m a j o t^
ธรรมรสโสภณ	th a m^ m a r o t^ s a ph oo n^
ธรรมรังสี	th a m^ r a ng^ s ii
ธรรมวัฒนะ	th a m^ m a w a t^ th a n a
ธรรมวิมล	th a m^ m a w i m o n^
ธรรมวุฒิ	th a m^ m a w u t^
ธรรมศักดิ์	th a m^ s a k^
ธรรมศิริ	th a m^ s i r i
ธรรมศิลป์	th a m^ s i n^
ธรรมสัจจานันท์	th a m^ s a t^ c aa n a n^
ธรรมสาร	th a m^ m a s aa n^
ธรรมสาโรรัชต์	th a m^ m a s aa r oo r a t^
ธรรมสโรช	th a m^ s a r oo t^
ธรรมะรัตน์ธนดี	th a m^ m a r a t^ th o n^ d ii
ธรรมาวุธ	th a m^ m aa w u t^
ธรรมเกษร	th a m^ m a k a s ee n^
ธรรมเพชร	th a m^ ph ee t^
ธรรมโชติ	th a m^ m a ch oo t^
ธรรมไชยวัฒน์	th a m^ ch a j^ j a w a t^
ธราธร	th a r aa th @@ n^
ธวัชผ่องศรี	th a w a t^ ph @ ng^ s ii
ธวัชภักดี	th a w a t^ ch a ph a k^ d ii
ธัญญา	th a n^ j aa
ธัญไพบูลย์	th a n^ j a ph a j^ b uu n^
ธาดาธำรงเวช	th aa d aa th a m^ r o ng^ w ee t^
ธารณา	th aa r a n aa
ธารทอง	th aa n^ th @@ ng^
ธารใส	th aa n^ s a j^
ธำรงธัญวงศ์	th a m^ r o ng^ th a n^ w o ng^
ธำรงนาวาสวัสดิ์	th a m^ r o ng^ n aa w aa t^ s a w a t^
ธำรงรัตนฤทธิ์	th a m^ r o ng^ r a t^ t a n a r i t^
ธำรงศุภกร	th a m^ r o ng^ s u p^ ph a k @@ n^
ธิดาทิตย์	th i d aa th i t^
ธิติกานต์	th i t i k aa n^
ธิปะโชติ	th i p a ch oo t^
ธีมากร	th ii m aa k @@ n^
ธีรธมฺโม	th ii r a th a m m oo
ธีรนิธิศนันท์	th ii r a n i th i t^ s a n a n^
ธีรพัฒน์	th ii r a ph a t^
ธีรภัทร	th ii r a ph a t^
ธีรภาพไพสิฐ	th ii r a ph aa p^ ph a j^ s i t^
ธีระชาติ	th ii r a ch aa t^
ธีระธาดา	th ii r a th aa d aa
ธีระพงษ์	th ii r a ph o ng^
ธีระรัตน์สกุล	th ii r a r a t^ s a k u n^
ธีระวงศ์ไพศาล	th ii r a w o ng^ ph a j^ s aa n^
ธีระวัฒนสุข	th ii r a w a t^ th a n a s u k^
ธีระวิวัฒน์	th ii r a w i w a t^
ธีระโรจนพงษ์	th ii r a r oo t^ c a n a ph o ng^
ธีราธนันพัฒน์	th ii r aa th a n a n^ ph a t^
ธีรเวคิน	th ii r a w ee kh i n^
ธีวีระปัญญา	th ii w ii r a p a n^ j aa
ธุวธรรม	th u w a th a m^
ธูปกล่ำ	th uu p^ kl a m^
นครนายก	n a kh @@ n^ n aa j o k^
นครปฐม	n a kh @@ n^ p a th o m^
นครสวรรค์	n a kh @@ n^ s a w a n^
นครหลวงโปรโมชั่น	n a kh @@ n^ l uua ng^ pr oo m oo ch a n^
นนทะดี	n o n^ th a d ii
นนทะสิน	n o n^ th a s i n^
นพขำ	n o p^ ph a kh a m^
นพจินดา	n o p^ c i n^ d aa
นพพงษากิจ	n o p^ ph o ng^ s aa k i t^
นพพร	n o p^ ph @@ n^
นพรัตน์	n o p^ ph a r a t^
นพฤทธิ์	n o p^ ph a r i t^
นพวิชัย	n o p^ ph a w i ch a j^
นพสิทธิ์	n o p^ s i t^
นพอมรบดี	n o p^ ph a z a m @@ n^ b @@ d ii
นพเกตุ	n o p^ ph a k ee t^
นภาพล	n a ph aa ph o n^
นภาลัย	n a ph aa l a j^
นภีตะภัฏ	n a ph ii t a ph a t^
นรปติ	n a r o p^ t i
นราตรีกุล	n a r aa tr ii k u n^
นรินทร์รักษ์	n a r i n^ r a k^
นริพทะพันธุ์	n a r i p^ th a ph a n^
นฤคุปต์ชาญชัย	n a r v a kh u p^ ch aa n^ ch a j^
นฤภัย	n a r v ph a j^
นวคุณากร	n a w a kh u n aa k @@ n^
นวมสุคนธ์	n uua m^ s u kh o n^
นวรัตน์	n a w a r a t^
นวลมณี	n uua n^ m a n ii
นวลมี	n uua n^ m ii
นวลสกุล	n uua n^ s a k u n^
นวลเปียน	n uua n^ p iia n^
นวลแจ่ม	n uua n^ c xx m^
นวแสงอรุณ	n a w a s xx ng^ z a r u n^
นะมาตร์	n a m aa t^
นักดนตรี	n a k^ d o n^ tr ii
นักตะเฆ่	n a k^ t a kh ee
นักบาลี	n a k^ b aa l ii
นันทขว้าง	n a n^ th a khw aa ng^
นันทจิต	n a n^ th a c i t^
นันทนาคร	n a n^ th a n aa kh @@ n^
นันทมานพ	n a n^ th a m aa n o p^
นันทวิเชียรฤทธิ์	n a n^ th a w i ch iia n^ r i t^
นันทะศรี	n a n^ th a s ii
นันทิวาส	n a n^ th i w aa t^
นันทเสนามาตร์	n a n^ th a s ee n aa m aa t^
นันทโพธิ์เดช	n a n^ th a ph oo d ee t^
นัมคณิสร	n a m^ kh a n i t^ s a r a
นัยนา	n a j^ j a n aa
นาคฉัตรีย์	n aa k^ ch a t^ tr ii
นาคทอง	n aa k^ th @@ ng^
นาคนันทน์	n aa k^ kh a n a n^
นาคนายม	n aa k^ kh a n aa j o m^
นาคบุญนำ	n aa k^ b u n^ n a m^
นาคประสงค์	n aa k^ pr a s o ng^
นาคประสิทธิ์	n aa k^ pr a s i t^
นาคปาน	n aa k^ p aa n^
นาคพงศ์	n aa k^ kh a ph o ng^
นาคภู่	n aa k^ ph uu
นาครทรรพ	n aa kh @@ n^ th a p^
นาครัตน์	n aa k^ kh a r a t^
นาควัชระ	n aa k^ w a t^ ch a r a
นาควานิช	n aa k^ w aa n i t^
นาควิไลโรจน์	n aa k^ w i l a j^ r oo t^
นาคศิริ	n aa k^ kh a s i r i
นาคสมภพ	n aa k^ s o m^ ph o p^
นาคสุริยะ	n aa k^ s u r i j a
นาคหิรัญกนก	n aa k^ h i r a n^ k a n o k^
นาคะตะ	n aa k^ kh a t a
นาคะพันธ์	n aa kh a ph a n^
นาคะเสถียร	n aa kh a s a th iia n^
นาคาศัย	n aa kh aa s a j^
นาคาฮาร่า	n aa kh aa h aa r aa
นาคีรักษ์	n aa kh ii r a k^
นาคเอี่ยม	n aa k^ z iia m^
นาชาญ	n aa ch aa n^
นาฏยลักษณ์	n aa t^ t a j^ l a k^
นาถา	n aa th aa
นาทองบ่อจรัส	n aa th @@ ng^ b @@ c a r a t^
นานอก	n aa n @@ k^
นานา	n aa n aa
นาน่วม	n aa n uua m^
นามกูล	n aa m^ m a k uu n^
นามขุนทด	n aa m^ m a kh u n^ th o t^
นามนวด	n aa m^ n uua t^
นามบุตร	n aa m^ b u t^
นามปาน	n aa m^ p aa n^
นามวงศ์	n aa m^ w o ng^
นามวงษ์	n aa m^ w o ng^
นามวิเศษ	n aa m^ w i s ee t^
นามสีฐาน	n aa m^ s ii th aa n^
นามอนุ	n aa m^ z a n u
นามเขต	n aa m^ m a kh ee t^
นามเดช	n aa m^ m a d ee t^
นารายณ์มหาราช	n aa r aa j^ m a h aa r aa t^
นารีจันทร์	n aa r ii c a n^
นาล์ม	n aa m^
นาวันโน	n aa w a n^ n oo
นาวิกมูล	n aa w i k a m uu n^
นาวีอันดามัน	n aa w ii z a n^ d aa m a n^
นาเมืองรักษ์	n aa m vva ng^ r a k^
นำโชค	n a m^ ch oo k^
นิกรเทศ	n i k @@ n^ th ee t^
นิงสานนท์	n i ng^ s aa n o n^
นิตยารัมภ์พงศ์	n i t^ t a j aa r a m^ ph o ng^
นิติพน	n i t i ph o n^
นิติภานนท์	n i t i ph aa n o n^
นิติสิริ	n i t i s i r i
นิติไกรพจน์	n i t i kr a j^ ph o t^
นิตโย	n i t^ j oo
นิธินพรัศม์	n i th i n o p^ ph a r a t^
นิธิไพศาลกุล	n i th i ph a j^ s aa n^ k u n^
นิมจิรวัฒน์	n i m^ c i r a w a t^
นิมมลรัตน์	n i m^ m o n^ r a t^
นิมมานเหมินท์	n i m^ m aa n^ h ee m i n^
นิมากรณ์	n i m aa k @@ n^
นิมิตชัย	n i m i t^ ch a j^
นิมิบุตร	n i m i b u t^
นิยม	n i j o m^
นิยมการณ์	n i j o m^ k aa n^
นิยมทรัพย์	n i j o m^ s a p^
นิยากร	n i j aa k @@ n^
นิรันดร์กุล	n i r a n^ k u n^
นิราพาธพงศ์พร	n i r aa ph aa t^ ph o ng^ ph @@ n^
นิลกลัด	n i n^ kl a t^
นิลคูหา	n i n^ kh uu h aa
นิลจุลกะ	n i n^ c u n^ l a k a
นิลถนอม	n i n^ th a n @@ m^
นิลนพรัตน์	n i n^ n o p^ ph a r a t^
นิลบูรพา	n i n^ b uu r a ph aa
นิลประภา	n i n^ pr a ph aa
นิลวงศ์	n i n^ w o ng^
นิลหยก	n i n^ j o k^
นิละภา	n i l x ph aa
นิลไสว	n i n^ s a w a j^
นิวาตวงศ์	n i w aa t a w o ng^
นิวาศวัต	n i w aa t^ w a t^
นิสสัยพันธ์	n i t^ s a j^ ph a n^
นิสัยสม	n i s a j^ j a s o m^
นิสาลักษณ์	n i s aa l a k^
นิโรจน์	n i r oo t^
นิ่มทวัฒน์	n i m^ th a w a t^
นิ่มทัยสุข	n i m^ th a j^ s u k^
นิ่มมะโน	n i m^ m a n oo
นิ่มสกุล	n i m^ s a k u n^
นิ่มสุวรรณ	n i m^ s u w a n^
นิ่มเสมอ	n i m^ s a m qq
นีระสิงห์	n ii r a s i ng^
นีละไพจิตร	n ii l a ph a j^ c i t^
นึกแจ้ง	n v k^ c xx ng^
นุชนุ่ม	n u t^ ch a n u m^
นุปิง	n u p i ng^
นุศราสตร์สังข์	n u s a r aa s a ng^
นุอุปละ	n u z u p^ p a l a
นูกราฮา	n uu kr aa h aa
น้อมเจริญ	n @@ m^ c a r qq n^
น้อยชื่นพันธ์	n @@ j^ ch vv n^ ph a n^
น้อยมณี	n @@ j^ m a n ii
บรรจง	b a n^ c o ng^
บรรจงศิลป์	b a n^ c o ng^ s i n^
บรรณรุจิ	b a n^ n a r u c i
บรรณวัฒน์	b a n^ n a w a t^
บรรดาศักดิ์	b a n^ d aa s a k^
บรรทัดฐาน	b a n^ th a t^ th aa n^
บรรลือฤทธิ์	b a n^ l vv r i t^
บรรลือวงศ์	b a n^ l vv w o ng^
บริจินดากุล	b @@ r i c i n^ d aa k u n^
บริบาล	b @@ r i b aa n^
บริพัตร	b @@ r i ph a t^
บริรักษ์ศุภกร	b @@ r i r a k^ s u p^ ph a k @@ n^
บริหารวนเขตต์	b @@ r i h aa n^ w o n^ kh ee t^
บรู๊ค	br uu k^
บวรกีรติขจร	b a w @@ n^ k ii r a t i kh a c @@ n^
บวรวัฒนดิลก	b @@ w @@ r a w a t^ th a n a d i l o k^
บวรวิศรุติ	b a w @@ n^ w i t^ s a r u t^
บวรศิริเกียรติ	b a w @@ n^ s i r i k iia t^
บอย	b @@ j^
บังคมเนตร	b a ng^ kh o m^ n ee t^
บัญชาเมฆ	b a n^ ch aa m ee k^
บัณฑิตกุล	b a n^ d i t^ k u n^
บัณฑิตสกุล	b a n^ d i t^ s a k u n^
บัณสิทธิ์	b a n^ n a s i t^
บัดติยา	b a t^ t i j aa
บัลลินี	b a n^ l i n ii
บัวขำ	b uua kh a m^
บัวคำศรี	b uua kh a m^ s ii
บัวงาม	b uua ng aa m^
บัวตูม	b uua t uu m^
บัวทอง	b uua th @@ ng^
บัวบังศร	b uua b a ng^ s @@ n^
บัวบุศย์	b uua b u t^
บัวอินทร์	b uua z i n^
บัวเจริญ	b uua c a r qq n^
บัวเบา	b uua b a w^
บัวแก้ว	b uua k xx w^
บัวแย้ม	b uua j xx m^
บัวไทย	b uua th a j^
บางคมบาง	b aa ng^ kh o m^ b aa ng^
บางยี่ขัน	b aa ng^ j ii kh a n^
บางสพาน	b aa ng^ s a ph aa n^
บานแย้ม	b aa n^ j xx m^
บารู	b aa r uu
บาร์โบส	b aa b oo t^
บาเล็นซิเอก้า	b aa l e n^ s i z ee k aa
บำรุงกิจ	b a m^ r u ng^ k i t^
บำรุงตระกูล	b a m^ r u ng^ tr a k uu n^
บำรุงพงศ์	b a m^ r u ng^ ph o ng^
บำรุงรักษ์	b a m^ r u ng^ r a k^
บำรุงสุข	b a m^ r u ng^ s u k^
บิณฑสันต์	b i n^ th a s a n^
บินอับดุลเลาะมาน	b i n^ z a p^ d u n^ l @ m aa n^
บิ๊กส์	b i k^
บีเวอร์	b ii w qq
บือราเฮง	b vv r aa h e ng^
บุญครองทรัพย์	b u n^ khr @@ ng^ s a p^
บุญคำ	b u n^ kh a m^
บุญค้ำ	b u n^ kh a m^
บุญงามอนงค์	b u n^ ng aa m^ z a n o ng^
บุญจวง	b u n^ c uua ng^
บุญจำนงค์	b u n^ c a m^ n o ng^
บุญชมไพศาล	b u n^ ch o m^ ph a j^ s aa n^
บุญชัยสุข	b u n^ ch a j^ s u k^
บุญชิต	b u n^ ch i t^
บุญญสถิตย์	b u n^ j a s a th i t^
บุญญา	b u n^ j aa
บุญญาธิการ	b u n^ j aa th i k aa n^
บุญญานันต์	b u n^ j aa n a n^
บุญญามณี	b u n^ j aa m a n ii
บุญตัน	b u n^ t a n^
บุญถนอม	b u n^ th a n @@ m^
บุญทรงไพศาล	b u n^ s o ng^ ph a j^ s aa n^
บุญทวี	b u n^ th a w ii
บุญทอง	b u n^ th @@ ng^
บุญธนาพิบูลย์	b u n^ th a n aa ph i b uu n^
บุญนะโชติ	b u n^ n a ch oo t^
บุญประกอบ	b u n^ pr a k @@ p^
บุญประชม	b u n^ pr a ch o m^
บุญภักดี	b u n^ ph a k^ d ii
บุญภัทรรักษา	b u n^ ph a t^ th a r a r a k^ s aa
บุญภูพันธ์ตันติ	b u n^ ph uu ph a n^ t a n^ t i
บุญมา	b u n^ m aa
บุญมาทัน	b u n^ m aa th a n^
บุญมาเลิศ	b u n^ m aa l qq t^
บุญมี	b u n^ m ii
บุญยงค์	b u n^ j o ng^
บุญยรัตกลิน	b u n^ j a r a t^ k a l i n^
บุญยรัตพันธุ์	b u n^ j a r a t^ t a ph a n^
บุญยฤทธิ์	b u n^ j a r i t^
บุญยศักดิ์	b u n^ j a s a k^
บุญยืน	b u n^ j vv n^
บุญยู้	b u n^ j uu
บุญรอด	b u n^ r @@ t^
บุญรัตนธนากร	b u n^ r a t^ t a n a th a n aa k @@ n^
บุญรับทรัพย์	b u n^ r a p^ s a p^
บุญราช	b u n^ r aa t^
บุญฤทธิ์	b u n^ r i t^
บุญลัภยานันท์	b u n^ l a p^ j aa n a n^
บุญวรรณ	b u n^ w a n^
บุญวรเมธี	b u n^ w @@ r a m ee th ii
บุญวิสุทธิ์	b u n^ w i s u t^
บุญศรี	b u n^ s ii
บุญศล	b u n^ s o n^
บุญศิริพันธ์	b u n^ s i r i ph a n^
บุญศิริวัฒนกุล	b u n^ s i r i w a t^ th a n a k u n^
บุญสวัสดิ์	b u n^ s a w a t^
บุญสัมพันธ์	b u n^ s a m^ ph a n^
บุญสาร	b u n^ s aa n^
บุญสิงคาร	b u n^ s i ng^ kh aa n^
บุญสิงห์	b u n^ s i ng^
บุญสุข	b u n^ s u k^
บุญสุภา	b u n^ s u ph aa
บุญสุวรรณ	b u n^ s u w a n^
บุญสูงเนิน	b u n^ s uu ng^ n qq n^
บุญหนัก	b u n^ n a k^
บุญหนุน	b u n^ n u n^
บุญอ้อม	b u n^ z @@ m^
บุญเกษม	b u n^ k a s ee m^
บุญเชียง	b u n^ ch iia ng^
บุญเดช	b u n^ d ee t^
บุญเฟื้อง	b u n^ f vva ng^
บุญเรือง	b u n^ r vva ng^
บุญเลิศ	b u n^ l qq t^
บุญเลี้ยง	b u n^ l iia ng^
บุญเสก	b u n^ s ee k^
บุญเสนอ	b u n^ s a n qq
บุญเสรฐ	b u n^ s t^
บุญเส็ง	b u n^ s e ng^
บุญใหญ่	b u n^ j a j^
บุณยรักษ์	b u n^ j a r a k^
บุณยสุขานนท์	b u n^ j a s u kh aa n o n^
บุณยะจินดา	b u n^ j a c i n^ d aa
บุณยะชัย	b u n^ j a ch a j^
บุณยะภูติ	b u n^ j a ph uu t^
บุณยะมาน	b u n^ j a m aa n^
บุณยเกตุ	b u n^ j a k ee t^
บุณยเกียรติ	b u n^ j a k iia t^
บุณโยทยาน	b u n^ j oo th a j aa n^
บุตรขัน	b u t^ kh a n^
บุตรจินดา	b u t^ c i n^ d aa
บุตรดี	b u t^ d ii
บุตรด้วง	b u t^ d uua ng^
บุตรพรม	b u t^ phr o m^
บุตรวงษ์	b u t^ w o ng^
บุตรศรี	b u t^ s ii
บุตรศรีภูมิ	b u t^ s ii ph uu m^
บุตรสมบัติ	b u t^ s o m^ b a t^
บุนนาค	b u n^ n aa k^
บุนปาน	b u n^ p aa n^
บุย	b u j^
บุรกรรมโกวิท	b u r a k a m^ k oo w i t^
บุรฉัตร	b u r a ch a t^
บุรณศิริ	b u r a n a s i r i
บุรพลชัย	b u p^ ph a l a ch a j^
บุราณ	b u r aa n a
บุราณสุข	b u r aa n a s u k^
บุรินทร์	b u r i n^
บุรีรัตน์	b u r ii r a t^
บุศยศิริ	b u t^ s i r i
บุษบา	b u t^ s a b aa
บุษผา	b u t^ s a ph aa
บุษราคัม	b u t^ s a r aa kh a m^
บุษราคัมวงษ์	b u t^ s a r aa kh a m^ w o ng^
บุษราคัมวดี	b u t^ s a r aa kh a m^ w a d ii
บูรณะประเสริฐสุข	b uu r a n a pr a s qq t^ s u k^
บูรณะเครือ	b uu r a n a khr vva
บูรณุปกรณ์	b uu r a n u p a k @@ n^
บูรณ์พงศ์	b uu n^ ph o ng^
บูรณ์สิริจรุงรัฐ	b uu n^ s i r i c a r u ng^ r a t^
บูรพชัยศรี	b uu r a ph a ch a j^ s ii
บูรพาชยานนท์	b uu r a ph aa ch a j aa n o n^
บูลกุล	b uu n^ k u n^
บูเฮอร์	b uu h @@
บ่อทอง	b @@ th @@ ng^
บ้านกล้วยยิม	b aa n^ kl uua j^ j i m^
บ้านดอน	b aa n^ d @@ n^
บ้านเจริญสุข	b aa n^ c a r qq n^ s u k^
ปงกันมูล	p o ng^ k a n^ m uu n^
ปฏิมาประกร	p a t i m aa pr a k @@ n^
ปฐมพร	p a th o m^ ph @@ n^
ปฐมอรรฆย์กุล	p a th o m^ m a z a k^ k u n^
ปฐมโพธิ์ทอง	p a th o m^ m a ph oo th @@ ng^
ปฐวิกรณ์ยิม	p a th a w i k @@ n^ j i m^
ปฐวีกานต์	p a z ^ t a w ii k aa n^
ปทุมารักษ์	p a th u m aa r a k^
ปมุตฺโต	p a m u t^ t oo
ปรกติ	pr o k^ k a t i
ปรมะเจริญโรจน์	p a r a m a c a r qq n^ r oo t^
ปรมัตถากร	p a r a m a t^ th aa k @@ n^
ปรมัตถ์วินัย	p a r a m a t^ w i n a j^
ปรมิณ	p @@ r a m i n^
ประกอบของ	pr a k @@ p^ kh @@ ng^
ประกาศวุฒิสาร	pr a k aa t^ w u t^ th i s aa n^
ประจงใจ	pr a c o ng^ c a j^
ประจวบเหมาะ	pr a c uua p^ m @
ประชากริช	pr a ch aa kr i t^
ประดู่คู่ยามดี	pr a d uu kh uu j aa m^ d ii
ประถมปัทมะ	pr a th o m^ p a t^ th a m a
ประทีปากรชัย	pr a th ii p aa k @@ n^ ch a j^
ประทุมทิพย์	pr a th u m^ th i p^
ประทุมมาศ	pr a th u m^ m aa t^
ประทุมลี	pr a th u m^ l ii
ประทุมวงศ์	pr a th u m^ w o ng^
ประทุมวรรณ	pr a th u m^ w a n^
ประทุมสินธุ์	pr a th u m^ m a s i n^
ประทุมสุวรรณ	pr a th u m^ s u w a n^
ประธาน	pr a th aa n^
ประพุทธ์	pr a ph u t^
ประภากมล	pr a ph aa k a m o n^
ประภาษานนท์	pr a ph aa s aa n o n^
ประภาสโนบล	pr a ph aa t^ n oo b o n^
ประมลบาล	pr a m o n^ l a b aa n^
ประมวญ	pr a m uua n^
ประวันณา	pr a w a n^ n aa
ประสงค์สันติ	pr a s o ng^ s a n^ t i
ประสพชัย	pr a s o p^ ch a j^
ประสพดี	pr a s o p^ ph a d ii
ประสพสายพรกุล	pr a s o p^ s aa j^ ph @@ r a k u n^
ประสาตร์สาน	pr a s aa s aa n^
ประสารราชกิจ	pr a s aa n^ r aa t^ ch a k i t^
ประเสริฐกุล	pr a s qq t^ k u n^
ประเสริฐวัฒนกุล	pr a s qq t^ w a t^ th a n a k u n^
ประเสริฐสกุล	pr a s qq t^ s a k u n^
ประเสริฐสม	pr a s qq t^ s o m^
ประเสริฐสุวรรณ	pr a s qq t^ s u w a n^
ประโดยคำ	pr a d oo j^ kh a m^
ปรัชญาบำรุง	pr a t^ j aa b a m^ r u ng^
ปรัชญารุ่งโรจน์	pr a t^ j aa r u ng^ r oo t^
ปราศจากศัตรู	pr aa t^ s a c aa k^ s a t^ tr uu
ปราสาทหินพิมาย	pr aa s aa t^ h i n^ ph i m aa j^
ปราโมช	pr aa m oo t^
ปริญญารักษ์	p a r i n^ j aa r a k^
ปริปุณโณ	pr i p u n oo
ปริศนานันทกุล	pr i t^ s a n aa n a n^ th a k u n^
ปรีชาชนะชัย	pr ii ch aa ch a n a ch a j^
ปรีดา	pr ii d aa
ปรีดามาโนช	pr ii d aa m aa n oo t^
ปรีดียานนท์	pr ii d ii j aa n o n^
ปรีย์มาโนช	p a r ii m aa n oo t^
ปลัดศรีช่วย	pl a t^ s ii ch uua j^
ปลั่งศรีสกุล	pl a ng^ s ii s a k u n^
ปลั่งศิริ	pl a ng^ s i r i
ปลั่งสุชน	pl a ng^ s u ch o n^
ปลั่งเวช	pl a ng^ w ee t^
ปลีนารัมย์	pl ii n aa r a m^
ปลื้มปรีดาพร	pl vv m^ pr ii d aa ph @@ n^
ปสุตนาวิน	p a s u t^ n aa w i n^
ปะการะนัง	p a k aa r a n a ng^
ปะติเส	p a t i s ee
ปักการะถา	p a k^ k aa r a th aa
ปักษี	p a k^ s ii
ปัจฉิมสวัสดิ์	p a t^ ch i m^ s a w a t^
ปัจฉิมานนท์	p a t^ ch i m aa n o n^
ปัญจพรรค์	p a n^ c a ph a n^
ปัญจวีณิน	p a n^ c a w ii n i n^
ปัญญา	p a n^ j aa
ปัญญากิตตินันท์	p a n^ j aa k i t^ t i n a n^
ปัญญาชาติรักษ์	p a n^ j aa ch aa t i r a k^
ปัญญายงค์	p a n^ j aa j o ng^
ปัญญาวงศ์	p a n^ j aa w o ng^
ปัญญาสกุลวงศ์	p a n^ j aa s a k u n^ w o ng^
ปัญญาเรือน	p a n^ j aa r vva n^
ปัญญโชติ	p a n^ j a ch oo t^
ปัญหกาญจน์	p a n^ h a k aa n^
ปัญโญภาส	p a n^ j oo ph aa t^
ปัตตพงศ์	p a t^ t a ph o ng^
ปัตถพงษ์	p a t^ th a ph o ng^
ปัทมคันธิน	p a t^ th a m a kh a n^
ปัทมสูต	p a t^ th a m a s uu t^
ปัทมะ	p a t^ th a m a
ปันจ้อย	p a n^ c @ j^
ปันยารชุน	p a n^ j aa r a ch u n^
ปั่นปี	p a n^ p ii
ปั้นทอง	p a n^ th @@ ng^
ปั้นเกตุ	p a n^ k ee t^
ปั้นเจริญ	p a n^ c a r qq n^
ปั้นเปี่ยมรัษฎ์	p a n^ p iia m^ r a t^
ปากหวาน	p aa k^ w aa n^
ปาจรียางกูร	p aa c a r ii j aa ng^ k uu n^
ปาทาน	p aa th aa n^
ปานจันทร์	p aa n^ c a n^
ปานทอง	p aa n^ th @@ ng^
ปานพุ่ม	p aa n^ ph u m^
ปานลักษณ์	p aa n^ l a k^
ปานศรีงาม	p aa n^ s ii ng aa m^
ปานะนนท์	p aa n a n o n^
ปานเจริญ	p aa n^ c a r qq n^
ปานเอี่ยม	p aa n^ z iia m^
ปานโต	p aa n^ t oo
ปาน้อยนนท์	p aa n @@ j^ n o n^
ปาปะนัย	p aa p a n a j^
ปาลกะวงศ์	p aa l a k a w o ng^
ปาลาเร่	p aa l aa r ee
ปิตตาโส	p i t^ t aa s oo
ปิตรชาติ	p i t^ tr a ch aa t^
ปิตะฝ่าย	p i t e f aa j^
ปิตินันท์	p i t i n a n^
ปิติสานต์	p i t i s aa n^
ปิติโรจน์จิรธร	p i t i r oo t^ c i r a th @@ n^
ปิตุเตชะ	p i t u t ee ch a
ปิยธรรมชัย	p i j a th a m^ m a ch a j^
ปิยภัทร์กิติ	p i j a ph a t^ k i t i
ปิยวรรณ	p i j a w a n^
ปิยสีโล	p i j a s ii l oo
ปิยะนุวัฒน์ชัย	p i j a n u w a t^ ch a j^
ปิยะปภากรกูล	p i j a p a ph aa k @@ n^ r a k uu n^
ปิยะภาณี	p i j a ph aa n ii
ปิยะวิรัทธิ์	p i j a w i r a t^
ปิยะสกุลแก้ว	p i j a s a k u n^ k xx w^
ปิยะอุย	p i j a z u j^
ปิสัญธนะกูล	p i s a n^ th a n a k uu n^
ปิ่นกอง	p i n^ k @@ ng^
ปิ่นขยัน	p i n^ kh a j a n^
ปิ่นชาตรี	p i n^ ch aa tr ii
ปิ่นทอง	p i n^ th @@ ng^
ปิ่นประดับ	p i n^ pr a d a p^
ปิ่นประทีป	p i n^ pr a th ii p^
ปิ่นมณี	p i n^ m a n ii
ปิ่นสินชัย	p i n^ s i n^ ch a j^
ปิ่นสุวรรณ	p i n^ s u w a n^
ปิ่นเกษร	p i n^ k ee s @@ n^
ปิ่นเฉลียว	p i n^ ch a l iia w^
ปิ่นแก้ว	p i n^ k xx w^
ปีนะกาตาโพธิ์	p ii n a k aa t aa ph oo
ปุญญานุภาพ	p u n^ j aa n u ph aa p^
ปุณณกันต์	p u n^ n oo k a n^
ปุณภพ	p u n^ n a ph o p^
ปุยเปีย	p u j^ p iia
ปุริสาย	p u r i s aa j^
ปุษปาคม	p u t^ s a p aa kh o m^
ปุ้ยตระกูล	p u j^ tr a k uu n^
ปูคะวนัช	p uu kh a w a n a t^
ปูนอินทรียิม	p uu n^ z i n^ th a r ii j i m^
ป้อมบุปผา	p @ m^ b u p^ ph aa
ป้อมพันธุ์	p @@ m^ ph a n^
ป้อมสุวรรณ	p @@ m^ s u w a n^
ป้อมเสมา	p @@ m^ s ee m aa
ผกา	ph a k aa
ผกาพันธุ์	ph a k aa ph a n^
ผดุงธรรม	ph a d u ng^ th a m^
ผดุงวัฒนะโชค	ph a d u ng^ w a t^ th a n a ch oo k^
ผดุงวิถี	ph a d u ng^ w i th ii
ผดุงสิทธิ์	ph a d u ng^ s i t^
ผดุงโชค	ph a d u ng^ ch oo k^
ผลชีวิน	ph o n^ ch ii w i n^
ผลดี	ph o n^ d ii
ผลพานิชย์	ph o n^ ph aa n i t^
ผลฟูตระกูล	ph o n^ f uu tr a k uu n^
ผลหิรัญ	ph o n^ h i r a n^
ผลาสินธุ์	phl a s i n^
ผลิตผลการพิมพ์	ph a l i t^ ph o n^ k aa n^ ph i m^
ผลิพืช	phl i ph vv t^
ผลเลขา	ph o n^ l a l ee kh aa
ผสมทรัพย์	ph a s o m^ s a p^
ผันสืบ	ph a n^ s vv p^
ผาธรรม	ph aa th a m^
ผานิชกุล	ph aa n i t^ ch a k u n^
ผาบชมภู	ph aa p^ ch o m^ ph uu
ผามั่ง	ph aa m a ng^
ผาลา	ph aa l aa
ผาสุข	ph aa s u k^
ผาโคตร	ph aa kh oo t^
ผิวผ่อง	ph i w^ ph @@ ng^
ผิวอ่อน	ph i w^ z @@ n^
ผี	ph ii
ผุงประเสริฐ	ph u ng^ pr a s qq t^
ผ่องผุดพันธ์	ph @ ng^ ph u t^ ph a n^
ผ่องศรี	ph @ ng^ s ii
ผ่องเจริญกุล	ph @ ng^ c a r qq n^ k u n^
ผ่องแผ้ว	ph @@ ng^ ph xx w^
ผ่องโชค	ph @@ ng^ ch oo k^
ผ่องโสภา	ph @@ ng^ s oo ph aa
ผ่านสำแดง	ph aa n^ s a m^ d xx ng^
ฝอยทอง	f @@ j^ th @@ ng^
ฝั้นแก้ว	f a n^ k xx w^
ฝ่ายอินทร์	f aa j^ z i n^
พงศธร	ph o ng^ s a th @@ n^
พงศ์กัมปนาท	ph o ng^ k a m^ p a n aa t^
พงศ์ทรง	ph o ng^ s o ng^
พงศ์ทิพย์สุคนธ์	ph o ng^ th i p^ s u kh o n^
พงศ์ภัณฑารักษ์	ph o ng^ ph a n^ th aa r a k^
พงศ์ภาณุ	ph o ng^ ph aa n u
พงศ์ศิลป์พิพัฒน์	ph o ng^ s i n^ ph i ph a t^
พงศ์สุชาติ	ph o ng^ s u ch aa t^
พงศ์เรืองรอง	ph o ng^ r vva ng^ r @@ ng^
พงษทัต	ph o ng^ s a th a t^
พงษ์ดำ	ph o ng^ d a m^
พงษ์ธนานิกร	ph o ng^ th a n aa n i k @@ n^
พงษ์นาค	ph o ng^ n aa k^
พงษ์ประยูร	ph o ng^ pr a j uu n^
พงษ์ประเสริฐ	ph o ng^ pr a s qq t^
พงษ์พันธุ์	ph o ng^ ph a n^
พงษ์พานิช	ph o ng^ ph aa n i t^
พงษ์พูล	ph o ng^ ph uu n^
พงษ์ภมร	ph o ng^ ph a m @@ n^
พงษ์มณี	ph o ng^ m a n ii
พงษ์มิตร	ph o ng^ m i t^
พงษ์รื่น	ph o ng^ r vv n^
พงษ์วานิช	ph o ng^ w aa n i t^
พงษ์วิไล	ph o ng^ w i l a j^
พงษ์ศิวาภัย	ph o ng^ s i w aa ph a j^
พงษ์สมบัติ	ph o ng^ s o m^ b a t^
พงษ์สิทธิศักดิ์	ph o ng^ s i t^ th i s a k^
พงษ์สุข	ph o ng^ s u k^
พงษ์สุทธิรักษ์	ph o ng^ s u t^ th i r a k^
พงษ์สุวรรณศิริ	ph o ng^ s u w a n^ n a s i r i
พงษ์อยู่	ph o ng^ j uu
พงษ์เจริญ	ph o ng^ c a r qq n^
พงษ์โสภณ	ph o ng^ s oo ph o n^
พงษ์ไพจิตร	ph o ng^ ph a j^ c i t^
พงษ์ไพบูลย์	ph o ng^ ph a j^ b uu n^
พจนาพิทักษ์	ph o t^ c a n aa ph i th a k^
พจน์โพธิ์ศรี	ph o t^ ph oo s ii
พณิชย์ผาติกรรม	ph a n i t^ ph aa t i k a m^
พนม	ph a n o m^
พนมยงค์	ph a n o m^ j o ng^
พนายางกูร	ph a n aa j aa ng^ k uu n^
พบประเสริฐ	ph o p^ pr a s qq t^
พยอมยงค์	ph a j @@ m^ j o ng^
พยัคฆบุตร	ph a j a k^ kh a b u t^
พยัคฆ์อนันต์	ph a j a k^ z a n a n^
พยัคฆ์อรุณ	ph a j a k^ z a r u n^
พยัฆโส	ph a j a k^ kh oo s oo
พรฉิม	ph @@ n^ ch i m^
พรชำนิ	ph @@ n^ ch a m^ n i
พรทวี	ph @@ n^ th a w ii
พรนารายณ์	ph @@ r a n aa r aa j^
พรประภา	ph @@ n^ pr a ph aa
พรพิมล	ph @@ n^ ph i m o n^
พรมพันห่าว	phr o m^ ph a n^ h aa w^
พรมรักษา	phr o m^ r a k^ s aa
พรมศร	phr o m^ s @@ n^
พรมสิงห์	phr o m^ s i ng^
พรมสุทธิ์	phr o m^ s u t^
พรมสุวรรณ	phr o m^ s u w a n^
พรมหล้า	phr o m^ m a l aa
พรรคเจริญ	ph a k^ c a r qq n^
พรรณบัว	ph a n^ b uua
พรรณเชษฐ์	ph a n^ n a ch ee t^
พรรัมเดช	ph @@ n^ r a m^ d ee t^
พรวิเชียร	ph @@ n^ w i ch iia n^
พรศิริ	ph @@ n^ s i r i
พรหมจรรย์	phr o m^ m a c a n^
พรหมชนะ	phr o m^ ch a n a
พรหมนอก	phr o m^ n @@ k^
พรหมบันดาล	phr o m^ b a n^ d aa n^
พรหมประทาน	phr o m^ pr a th aa n^
พรหมพฤกษ์	phr o m^ m a phr v k^
พรหมพันธุ์	phr o m^ ph a n^
พรหมภักดี	phr o m^ m a ph a k^ d ii
พรหมมาณพ	phr o m^ m aa n o p^
พรหมมินทร์	phr o m^ m i n^
พรหมยงค์	phr o m^ j o ng^
พรหมรักษ์	phr o m^ m a r a k^
พรหมรัด	phr o m^ r a t^
พรหมรัตน์	phr o m^ m a r a t^
พรหมรุ่งโรจน์	phr o m^ r u ng^ r oo t^
พรหมศิริ	phr o m^ s i r i
พรหมสาขา	phr o m^ s aa kh aa
พรหมสาโร	phr o m^ s aa r oo
พรหมสุภะ	phr o m^ s u ph a
พรหมา	phr o m aa
พรหมเลิศ	phr o m^ l qq t^
พรหมแดน	phr o m^ d xx n^
พรหมใจ	phr o m^ c a j^
พรอริยสมบัติ	ph @@ n^ z a r i j a s o m^ b a t^
พรอุดมศักดิ์	ph @@ n^ z u d o m^ s a k^
พระขรรค์ชัย	phr a kh a n^ ch a j^
พระบรมราชชนนีพันปีหลวง	phr a b @@ r o m^ r aa t^ ch o n^ n ii ph a n^ p ii l uua ng^
พระบรมราชินี	phr a b @@ r o m^ r aa ch i n ii
พระบรมราชินีนาถ	phr a b @@ r o m^ r aa ch i n ii n aa t^
พระบรมราชเทวี	phr a b @@ r o m^ r aa t^ th ee w ii
พระประแดง	phr a pr a d xx ng^
พระพันวัสสาอัยยิกาเจ้า	phr a ph a n^ w a t^ s aa z a j^ j i k aa c a w^
พระวชิรเกล้าเจ้าอยู่หัว	phr a w a ch i r a kl a w^ c a w^ j uu h uua
พระวรราชชายา	phr a w @@ r a r aa t^ ch a ch aa j aa
พระวรราชเทวี	phr a w @@ r a r aa t^ th ee w ii
พระองค์เจ้ากาญจนากร	phr a z o ng^ c aa w^ k aa n^ c a n aa k @@ n^
พระองค์เจ้ากิติยากรวรลักษณ์	phr a z o ng^ c aa w^ k i t i j aa k @@ n^ r a w @@ n^ l a k^
พระองค์เจ้าคัคณางคยุคล	phr a z o ng^ c aa w^ kh a k^ kh a n aa ng^ kh a j u kh o n^
พระองค์เจ้าจักรพันธ์เพ็ญศิริ	phr a z o ng^ c aa w^ c a k^ kr a ph a n^ ph e n^ s i r i
พระองค์เจ้าจันทรสุเทพ	phr a z o ng^ c aa w^ c a n^ th a r a s u th ee p^
พระองค์เจ้าจิรประวัติวรเดช	phr a z o ng^ c aa w^ c i r a pr a w a t^ w @@ r a d ee t^
พระองค์เจ้าจุมภฏพงษ์บริพัตร	phr a z o ng^ c aa w^ c u m^ ph o t^ ph o ng^ b @@ r i ph a t^
พระองค์เจ้าจุลจักรพงษ์	phr a z o ng^ c aa w^ c u n^ l a c a k^ kr a ph o ng^
พระองค์เจ้าชุมพลสมโภช	phr a z o ng^ c aa w^ ch u m^ ph o n^ s o m^ ph oo t^
พระองค์เจ้าดิศวรกุมาร	phr a z o ng^ c aa w^ d i t^ w @@ r a k u m aa n^
พระองค์เจ้าทองกองก้อนใหญ่	phr a z o ng^ c aa w^ th @@ ng^ k @@ ng^ k @@ n^ j a j^
พระองค์เจ้าทิพยสัมพันธ์	phr a z o ng^ c aa w^ th i p^ ph a j a s a m^ ph a n^
พระองค์เจ้าธานีนิวัต	phr a z o ng^ c aa w^ th aa n ii n i w a t^
พระองค์เจ้านภางค์นิพัทธพงศ์	phr a z o ng^ c aa w^ n a ph aa ng^ n i ph a t^ th a ph o ng^
พระองค์เจ้านวม	phr a z o ng^ c aa w^ n uua m^
พระองค์เจ้านักขัตรมงคล	phr a z o ng^ c aa w^ n a k^ kh a t^ m o ng^ kh o n^
พระองค์เจ้านารีรัตนา	phr a z o ng^ c aa w^ n aa r ii r a t^ t a n aa
พระองค์เจ้าบวรเดช	phr a z o ng^ c aa w^ b @@ w @@ r a d ee t^
พระองค์เจ้าบัญจบเบญจมา	phr a z o ng^ c aa w^ b a n^ c o p^ b ee n^ c a m aa
พระองค์เจ้าบุรฉัตรไชยากร	phr a z o ng^ c aa w^ b u r a ch a t^ ch a j^ j aa k @@ n^
พระองค์เจ้าปฤษฎางค์	phr a z o ng^ c aa w^ pr i t^ s a d aa ng^
พระองค์เจ้าพระอรุณนิภาคุณากร	phr a z o ng^ c aa w^ phr a z a r u n^ n i ph aa kh u n aa k @@ n^
พระองค์เจ้าพร้อมพงษ์อธิราช	phr a z o ng^ c aa w^ phr @@ m^ ph o ng^ z a th i r aa t^
พระองค์เจ้าพักตร์พิมลพรรณ	phr a z o ng^ c aa w^ ph a k^ ph i m o n^ ph a n^
พระองค์เจ้าพีรพงศ์ภาณุเดช	phr a z o ng^ c a w^ ph ii r a ph o ng^ ph aa n u d ee t^
พระองค์เจ้าภาณุพันธุ์ยุคล	phr a z o ng^ c aa w^ ph aa n u ph a n^ j u kh o n^
พระองค์เจ้ามณฑานพรัตน์	phr a z o ng^ c aa w^ m o n^ th aa n o p^ ph a r a t^
พระองค์เจ้ารพีพัฒนศักดิ์	phr a z o ng^ c aa w^ r a ph ii ph a t^ th a n a s a k^
พระองค์เจ้ารังสิตประยูรศักดิ์	phr a z o ng^ c aa w^ r a ng^ s i t^ pr a j uu n^ s a k^
พระองค์เจ้ารัชนีแจ่มจรัส	phr a z o ng^ c aa w^ r a t^ ch a n ii c x m^ c a r a t^
พระองค์เจ้าลดาวัลย์	phr a z o ng^ c aa w^ l a d aa w a n^
พระองค์เจ้าวรรณไวทยากร	phr a z o ng^ c aa w^ w a n^ w a j^ th a j aa k @@ n^
พระองค์เจ้าวรานนท์ธวัช	phr a z o ng^ c aa w^ w a r aa n o n^ th a w a t^
พระองค์เจ้าวัลลภาเทวี	phr a z o ng^ c aa w^ w a n^ l a ph aa th ee w ii
พระองค์เจ้าวาณีรัตนกัญญา	phr a z o ng^ c aa w^ w aa n ii r a t^ t a n a k a n^ j aa
พระองค์เจ้าวิภาวดีรังสิต	phr a z o ng^ c aa w^ w i ph aa w^ w a d ii r a ng^ s i t^
พระองค์เจ้าวิมลฉัตร	phr a z o ng^ c aa w^ w i m o n^ ch a t^
พระองค์เจ้าวิวัฒนไชย	phr a z o ng^ c aa w^ w i w a t^ th a n a ch a j^
พระองค์เจ้าวุฒิไชยเฉลิมลาภ	phr a z o ng^ c aa w^ w u t^ th i ch a j^ ch a l qq m^ l aa p^
พระองค์เจ้าศรีนาคสวาดิ	phr a z o ng^ c aa w^ s ii n aa k^ s a w aa d i
พระองค์เจ้าศรีสิทธิธงไชย	phr a z o ng^ c aa w^ s ii s i t^ th i th o ng^ ch a j^
พระองค์เจ้าสมัยวุฒิวโรดม	phr a z o ng^ c a w^ s a m a j^ w u t^ th i w a r oo d o m^
พระองค์เจ้าสวัสดิโสภณ	phr a z o ng^ c a w^ s a w a t^ d i s oo ph o n^
พระองค์เจ้าสิริภาจุฑาภรณ์	phr a z o ng^ c aa w^ s i r i ph aa c u th aa ph @@ n^
พระองค์เจ้าสุขุมาภินันท์	phr a z o ng^ c aa w^ s u kh u m aa ph i n a n^
พระองค์เจ้าอนุสรมงคลการ	phr a z o ng^ c a w^ z a n u s @@ n^ m o ng^ kh o n^ k aa n^
พระองค์เจ้าอรุณวดี	phr a z o ng^ c a w^ z a r u n^ w a d ii
พระองค์เจ้าอรไทยเทพกัญญา	phr a z o ng^ c aa w^ z @@ n^ th a j^ th ee p^ k a n^ j aa
พระองค์เจ้าอาทิตยาทรกิติคุณ	phr a z o ng^ c a w^ z aa th i t^ th a j aa th @@ n^ k i t^ t i kh u n^
พระองค์เจ้าอาทิตย์ทิพอาภา	phr a z o ng^ c a w^ z aa th i t^ th i p^ z aa ph aa
พระองค์เจ้าอาภากรเกียรติวงศ์	phr a z o ng^ c a w^ z aa ph aa k @@ n^ k iia t^ w o ng^
พระองค์เจ้าอิศรวงศ์วรราชกุมาร	phr a z o ng^ c aa w^ z i t^ s a r a w o ng^ w @@ r a r aa t^ k u m aa n^
พระองค์เจ้าอิศริยาภรณ์	phr a z o ng^ c aa w^ z i t^ s a r i j aa ph @@ n^
พระองค์เจ้าอุรุพงศ์รัชสมโภช	phr a z o ng^ c aa w^ z u r u ph o ng^ r a t^ ch a s o m^ ph oo t^
พระองค์เจ้าเกษมศรีศุภโยค	phr a z o ng^ c aa w^ k a s ee m^ s ii s u p^ ph a j oo k^
พระองค์เจ้าเขจรจิรประดิษฐ	phr a z o ng^ c aa w^ kh a c @@ n^ c i r a pr a d i t^
พระองค์เจ้าเจริญกมลสุขสวัสดิ์	phr a z o ng^ c aa w^ c a r qq n^ k a m o n^ s u k^ s a w a t^
พระองค์เจ้าเทวัญอุไทยวงศ์	phr a z o ng^ c aa w^ th ee w a n^ z u th a j^ j a w o ng^
พระองค์เจ้าเนาวรัตน์	phr a z o ng^ c aa w^ n a w^ w a r a t^
พระองค์เจ้าเปรมบุรฉัตร	phr a z o ng^ c aa w^ pr ee m^ b u r a ch a t^
พระองค์เจ้าเพ็ญพัฒนพงศ์	phr a z o ng^ c aa w^ ph e n^ ph a t^ th a n a ph o ng^
พระองค์เจ้าเสาวภาคย์นารีรัตน์	phr a z o ng^ c aa w^ s a w^ w a ph aa k^ n aa r ii r a t^
พระองค์เจ้าโสมสวลี	phr a z o ng^ c aa w^ s oo m^ s a w a l ii
พระองค์เจ้าไชยันตมงคล	phr a z o ng^ c aa w^ ch a j a n^ t a m o ng^ kh o n^
พระอัครราชเทวี	phr a z a k^ kh a r a r aa t^ th ee w ii
พระอัฐมรามาธิบดินทร	phr a z a t^ th a m a r aa m aa th i p^ b a d i n^
พรานมนัส	phr aa n^ m a n a t^
พริ้งพวงแก้ว	phr i ng^ ph uua ng^ k xx w^
พริ้งศุลกะ	phr i ng^ s u n^ l a k a
พริ้งเกษมชัย	phr i ng^ k a s ee m^ ch a j^
พรเพ็ญพิพัฒน์	ph @@ n^ ph e n^ ph i ph a t^
พรเวโรจน์	ph @@ r a w ee r oo t^
พรโชคชัย	ph @@ n^ ch oo k^ ch a j^
พรใส	ph @@ n^ s a j^
พร้อมพัฒน์	phr @@ m^ ph a t^
พร้อมพันธุ์	phr @@ m^ ph a n^
พร้อมสุข	phr @@ m^ s u k^
พฤกษากร	phr v k^ s aa k @@ n^
พฤกษาเกษมสุข	phr v k^ s aa k a s ee m^ s u k^
พฤกษ์สถาพร	phr v k^ s a th aa ph @@ n^
พลกองเส็ง	ph o n^ k @@ ng^ s e ng^
พลกุล	ph o n^ k u n^
พลคำ	ph o n^ l a kh a m^
พลจันทร	ph o n^ c a n^
พลชนะ	ph o n^ ch a n a
พลซา	ph o n^ s aa
พลซื่อ	ph o n^ s vv
พลนิกร	ph o n^ l a n i k @@ n^
พลบุตร	ph o n^ l a b u t^
พลบูรณ์	ph o n^ l a b uu n^
พลฤทธิ์	ph o n^ l a r i t^
พลศักดิ์	ph o n^ l a s a k^
พลศิลป	ph o n^ s i n^
พลสนะ	ph o n^ s a n a
พลสุวรรณ	ph o n^ s u w a n^
พลอยมีค่า	phl @@ j^ m ii kh aa
พลอยเพชร	phl @@ j^ ph ee t^
พลอินทร์	ph o n^ z i n^
พลัดเชื้อนิล	phl a t^ ch vva n i n^
พลาจิณ	phl aa c i n^
พลาพร	ph a l aa ph @@ n^
พลายนุ่ม	phl aa j^ n u m^
พลายเถื่อน	phl aa j^ th vva n^
พลาศรัย	ph a l aa s a j^
พลาศัย	ph a l aa s a j^
พลุแตก	phl u t xx k^
พลเดช	ph o n^ d ee t^
พลเรือง	ph o n^ r vva ng^
พลเสน	ph o n^ s ee n^
พลโคตร	ph o n^ kh oo t^
พลไชย	ph o n^ l a ch a j^
พลไวย์	ph o n^ w a j^
พวงทอง	ph uua ng^ th @@ ng^
พวงธนะสาร	ph uua ng^ th a n a s aa n^
พวงประยงค์	ph uua ng^ pr a j o ng^
พวงพั่วเพชร	ph uua ng^ ph uua ph ee t^
พวงราช	ph uua ng^ r aa t^
พวงสุพาง	ph uua ng^ s u ph aa ng^
พวงเพ็ชร์	ph uua ng^ ph e t^
พหลแพทย์	ph a h o n^ ph xx t^
พหลโยธิน	ph a h o n^ j oo th i n^
พหิทธานุกร	ph a h i t^ th aa n u k @@ n^
พะลัง	ph a l a ng^
พะโค	ph a kh oo
พัชรวีระพงษ์	ph a t^ ch a r a w ii r a ph o ng^
พัชรสุธาพิมลลักษณ	ph a t^ ch a r a s u th aa ph i m o n^ l a k^
พัชรี	ph a t^ ch a r ii
พัฒนกุล	ph a t^ th a n a k u n^
พัฒนกุลเลิศ	ph a t^ th a n a k u n^ l qq t^
พัฒนกูลกิจ	ph a t^ th a n a k uu n^ k i t^
พัฒนถาบุตร	ph a t^ th a n a th a w^ b u t^
พัฒนพงศ์	ph a t^ th a n a ph o ng^
พัฒนภูมิไท	ph a t^ th a n a ph uu m^ th a j^
พัฒนวีรคุณ	ph a t^ th a n a w ii r a kh u n^
พัฒนาการยิม	ph a t^ th a n aa k aa n^ j i m^
พัฒนุช	ph a t^ th a n u t^
พัฒนเศรษฐานนท์	ph a t^ th a n a s ee t^ th aa n o n^
พัฒนโชติ	ph a t^ th a n a ch oo t^
พัฒน์ดำรงจิตร	ph a t^ d a m^ r o ng^ c i t^
พัฒโน	ph a t^ th a n oo
พัทธสีมา	ph a t^ th a s ii m aa
พัธโนทัย	ph a t^ th a n oo th a j^
พันท้ายนรสิงห์	ph a n^ th aa j^ n @@ r a s i ng^
พันธนะอังกูร	ph a n^ th a n a z a ng^ k uu n^
พันธะลี	ph a n^ 0th a l ii
พันธุจริยา	ph a n^ th u c a r i j aa
พันธุมจินดา	ph a n^ th u m^ c i n^ d aa
พันธุมเลิศรุจี	ph a n^ th u m^ m a l qq t^ r u c ii
พันธุมโกมล	ph a n^ th u m^ k oo m o n^
พันธุรักษ์	ph a n^ th u r a k^
พันธุ์กระวี	ph a n^ kr a w ii
พันธุ์พงษ์ไทย	ph a n^ ph o ng^ th a j^
พันธุ์พฤกษ์	ph a n^ phr v k^
พันธุ์พิพัฒน์	ph a n^ ph i ph a t^
พันธุ์มณี	ph a n^ m a n ii
พันธุ์ยิ้ม	ph a n^ j i m^
พันธุ์ฤทธิ์	ph a n^ r i t^
พันธุ์วิชาติกุล	ph a n^ w i ch aa t^ k u
พันธุ์ศรีนคร	ph a n^ s ii n a kh @@ n^
พันธุ์ศิลา	ph a n^ s i l aa
พันธุ์หาญ	ph a n^ h aa n^
พันธุ์เจริญ	ph a n^ c a r qq n^
พันธุ์เพ็ง	ph a n^ ph e ng^
พันธุ์เมือง	ph a n^ m vva ng^
พันธุ์ไพโรจน์	ph a n^ ph a j^ r oo t^
พันธเศรษฐ	ph a n^ th a s ee t^
พันธ์พินิจ	ph a n^ ph i n i t^
พันธ์วิศวาส	ph a n^ w i t^ s a w aa t^
พันธ์สายเชื้อ	ph a n^ s aa j^ ch vva
พันธ์เจริญวรกุล	ph a n^ c a r qq n^ w @@ r a k u n^
พันธ์แพ	ph a n^ ph xx
พันนาสี	ph a n^ n aa s ii
พันภิพัฒน์	ph a n^ ph i ph a t^
พันสิทธิวรกุล	ph a n^ s i t^ th i w @@ r a k u n^
พันเลิศวงศ์สกุล	ph a n^ l qq t^ w o ng^ s a k u n^
พันโนน	ph a n^ n oo n^
พัวพิมล	ph uua ph i m o n^
พัววรานุเคราะห์	ph uua w a r aa n u khr @
พัสดุ	ph a t^ s a d u
พั่วนะคุณมี	ph uua n a kh u n^ m ii
พั้วช่วย	ph uua ch uua j^
พาณิชจรูญ	ph aa n i t^ c a r uu n^
พาณิชย์ธำรง	ph aa n i t^ th a m^ r o ng^
พาณิชย์พงส์	ph aa n i t^ ph o ng^
พาทยกุล	ph aa th a j a k u n^
พานทอง	ph aa n^ th @@ ng^
พานประทีป	ph aa n^ pr a th ii p^
พานะบุตร	ph aa n a b u t^
พานิช	ph aa n i t^
พานิชกุล	ph aa n i t^ ch a k u n^
พานิชชัยกุล	ph aa n i t^ ch a j^ k u n^
พานิชพันธ์	ph aa n i t^ ch a ph a n^
พานิชภักดิ์	ph aa n i t^ ch a ph a k^
พานิชรักษาพงศ์	ph aa n i t^ r a k^ s aa ph o ng^
พานิชวิทย์	ph aa n i t^ ch a w i t^
พานิชสมัย	ph aa n i t^ s a m a j^
พานิชอุดม	ph aa n i t^ z u d o m^
พานุสิทธิ์	ph aa n u s i t^
พานแก้ว	ph aa n^ k xx w^
พาละพล	ph aa l a ph o n^
พาลุสุข	ph aa l u s u k^
พาวิทยลาภ	ph aa w i t^ th a j a l aa p^
พาโชค	ph aa ch oo k^
พิกุลทอง	ph i k u n^ th @@ ng^
พิจิตร	ph i c i t^
พิจิตรธรรม	ph i c i t^ tr a th a m^
พิจิตรา	ph i c i t^ tr aa
พิชวงค์	ph i t^ ch a w o ng^
พิชิตโชติรัตน์	ph i ch i t^ ch oo t^ r a t^
พิณทอง	ph i n^ th @@ ng^
พิณเมืองงาม	ph i n^ m vva ng^ ng aa m^
พิตรปรีชา	ph i t^ pr ii ch aa
พิทยะ	ph i t^ th a j a
พิทักษ์คุมพล	ph i th a k^ kh u m^ ph o n^
พิทักษ์ติกุล	ph i th a k^ t i k u n^
พิทักษ์พรพัลลภ	ph i th a k^ ph @@ ph a n^ l o p^
พิทักษ์โล่พานิช	ph i th a k^ l oo ph aa n i t^
พินดั้ม	ph i n^ d a m^
พินิจ	ph i n i t^
พินิวัตร์	ph i n i w a t^
พิบูลภานุวัธน	ph i b uu n^ ph aa n u w a th o n^
พิบูลย์	ph i b uu n^
พิบูลสงคราม	ph i b uu n^ s o ng^ khr aa m^
พิพัฒนาศัย	ph i ph a t^ th a n aa s a j^
พิพัฒนเสรีธรรม	ph i ph a t^ th a n a s ee r ii th a m^
พิพัฒน์ไชยศิริ	ph i ph a t^ ch a j^ s i r i
พิพิธภักดี	ph i ph i t^ th a ph a k^ d ii
พิมพิสาร	ph i m^ ph i s aa n^
พิมพ์คูณ	ph i m^ kh uu n^
พิมพ์พันธ์	ph i m^ ph a n^
พิมพ์รัตน์	ph i m^ r a t^
พิมพ์ศรี	ph i m^ s ii
พิมพ์ใจชน	ph i m^ c a j^ ch o n^
พิมวนา	ph i m^ w a n aa
พิมานทิพย์	ph i m aa n^ th i p^
พิมานเมฆินทร์	ph i m aa n^ m ee kh i n^
พิลาคลัง	ph i l aa khl a ng^
พิลาดวง	ph i l aa d uua ng^
พิศลยบุตร	ph i t^ s a l qq j^ b u t^
พิศสุวรรณ	ph i t^ s u w a n^
พิศัลยบุตร	ph i s a n^ j a b u t^
พิศาลชัย	ph i s aa n^ ch a j^
พิษณุราชันย์	ph i t^ s a n u r aa ch a n^
พิสิฐกุล	ph i s i t^ k u n^
พิสิฐวุฒินันท์	ph i s i t^ w u t^ th i n a n^
พิสิษฐบรรณกร	ph i s i t^ b a n^ n a k @@ n^
พิสิษวุฒิรัชต์	ph i s i t^ w u t^ th i r a t^
พิสุทธิ์	ph i s u t^
พิสุทธิ์ชัยกุล	ph i s u t^ ch a j^ k u n^
พิเชฐชัยยุทธ์	ph i ch ee t^ ch a j^ j u t^
พิเดช	ph i d ee t^
พีระศรี	ph ii r a s ii
พึ่งผูก	ph v ng^ ph uu k^
พึ่งพันธ์	ph v ng^ ph a n^
พึ่งยา	ph v ng^ j aa
พึ่งสุจริต	ph v ng^ s u t^ c a r i t^
พึ่งสุนทร	ph v ng^ s u n^ th @@ n^
พึ่งเจียม	ph v ng^ c iia m^
พืชมงคล	ph vv t^ m o ng^ kh o n^
พื้นแสน	ph vv n^ s xx n^
พุกกะเวส	ph u k^ k a w ee t^
พุกผาสุข	ph u k^ ph aa s u k^
พุกพบสุข	ph u k^ ph o p^ s u k^
พุกหอม	ph u k^ h @@ m^
พุคยาภรณ์	ph u kh a j aa ph @@ n^
พุฒ	ph u t^
พุฒซ้อน	ph u t^ s @@ n^
พุฒตาล	ph u t^ t aa n^
พุทธชาติ	ph u t^ th a ch aa t^
พุทธปวน	ph u t^ th a p uua n^
พุทธภิบาล	ph u t^ th a ph i b aa n^
พุทธินันทน์	ph u t^ th i n a n^
พุทฺธสโร	ph u t^ t^ s a r oo
พุ่มชูศรี	ph u m^ ch uu s ii
พุ่มทอง	ph u m^ th @@ ng^
พุ่มพันธุ์ม่วง	ph u m^ ph a n^ m uua ng^
พุ่มพันธ์ม่วง	ph u m^ ph a n^ m uua ng^
พุ่มพันธ์วงศ์	ph u m^ ph a n^ w o ng^
พุ่มสีนิล	ph u m^ s ii n i n^
พุ่มสุโข	ph u m^ s u kh oo
พุ่มหิรัญ	ph u m^ h i r a n^
พุ่มอ่อน	ph u m^ z @@ n^
พุ่มแจ้ง	ph u m^ c xx ng^
พุ่มโพธิงาม	ph u m^ ph oo ng aa m^
พูดฉลาด	ph uu t^ ch a l aa t^
พูนจังหรีด	ph uu n^ c a ng^ r ii t^
พูนธรัตน์	ph uu n^ th a r a t^
พูนผล	ph uu n^ ph o n^
พูนพัฒนสุข	ph uu n^ ph a t^ th a n a s u k^
พูนพัฒน์	ph uu n^ ph a t^
พูนพิริยะ	ph uu n^ ph i r i j a
พูนลาภ	ph uu n^ l aa p^
พูนสวัสดิ์	ph uu n^ s a w a t^
พูมสะหวัน	ph uu m^ s a w a n^
พูลทรัพย์สกุล	ph uu n^ s a p^ s a k u n^
พูลพิพัฒน์	ph uu n^ ph i ph a t^
พูลภีไกร	ph uu n^ ph ii kr a j^
พูลสวัสดิ์	ph uu n^ s a w a t^
พูลสุข	ph uu n^ s u k^
พูลเกิด	ph uu n^ k qq t^
พูลเลิศลาภ	ph uu n^ l qq t^ l aa p^
พฺรหฺมปัญโญ	ph o m^ m^ p a n^ j oo
พ่วงจันทร์	ph uua ng^ c a n^
พ่วงลิบ	ph uua ng^ l i p^
ฟลีโป	fl ii p oo
ฟองงาม	f @@ ng^ ng aa m^
ฟอร์ด	f @@ t^
ฟิโลเมน่า	f i l oo m ee n aa
ฟูกลิ่น	f uu kl i n^
ภทรธนกุล	ph o t^ th a n a k u n^
ภมรประวัติ	ph a m @@ n^ pr a w a t^
ภมรประเสริฐ	ph a m @@ n^ pr a s qq t^
ภมรมนตรี	ph a m @@ n^ m o n^ tr ii
ภราดรยิม	ph a r aa d @@ n^ j i m^
ภวภูตานนท์	ph a w a ph uu t aa n o n^
ภักดิ์สุขเจริญ	ph a k^ s u k^ c a r qq n^
ภักดีกุล	ph a k^ d ii k u n^
ภักดีดำรงฤทธิ์	ph a k^ d ii d a m^ r o ng^ r i t^
ภักดีธนากุล	ph a k^ d ii th a n aa k u n^
ภักดีประสงค์	ph a k^ d ii pr a s o ng^
ภักดีภูมิ	ph a k^ d ii ph uu m^
ภักดีวิจิตร	ph a k^ d ii w i c i t^
ภักดีสู่สุข	ph a k^ d ii s uu s u k^
ภักดีแก้ว	ph a k^ d ii k xx w^
ภัคเกษม	ph a k^ kh a k a s ee m^
ภัทรกำพล	ph a t^ th a r a k a m^ ph o n^
ภัทรกุลวณิชย์	ph a t^ th a r a k u n^ w a n i t^
ภัทรประสิทธิ์	ph a t^ th a r a pr a s i t^
ภัทรมานพ	ph a t^ th a r a m aa n o p^
ภัทรโชคชัย	ph a t^ thr a ch oo k^ ch a j^
ภาคสุโพธิ์	ph aa k^ s u ph oo
ภาคีรัตน์	ph aa kh ii r a t^
ภาณุพงศ์	ph aa n u ph o ng^
ภารสมบูรณ์	ph aa r a s o m^ b uu n^
ภาวิไล	ph aa w i l a j^
ภาษี	ph aa s ii
ภาสกรนที	ph aa t^ s a k @@ n^ n a th ii
ภาสะพันธุ์	ph aa s a ph a n^
ภาโส	ph aa s oo
ภิญญสาสน์	ph i n^ j a s aa t^
ภิญโญ	ph i n^ j oo
ภิรมย์	ph i r o m^
ภิรมย์พร	ph i r o m^ ph @@ n^
ภิรมย์ภักดี	ph i r o m^ ph a k^ d ii
ภีระพัภร์กุญช์ชญา	ph ii r a ph a phr k u n^ ch @@ ch a j aa
ภุมมะกาญจนะ	ph u m^ m a k aa n^ c a n a
ภูธนัตถ์วฤนร์	ph uu th a n a t^ w a r v n^
ภูธรใจ	ph uu th @@ n^ c a j^
ภูผิวเดือน	ph uu ph i w^ d vva n^
ภูมิจันทึก	ph uu m^ c a n^ th v k^
ภูมิจิตร	ph uu m^ c i t^
ภูมิณรงค์	ph uu m i n a r o ng^
ภูมิดิษฐ์	ph uu m i d i t^
ภูมิรัตน	ph uu m^ r a t^
ภูมิศักดิ์	ph uu m i s a k^
ภูยุทธานนท์	ph uu j u t^ th aa n o n^
ภูริพัฒน์	ph uu r i ph a t^
ภูรีศรีศักดิ์	ph uu r ii s ii s a k^
ภูวกุล	ph uu w a k u n^
ภูวนัย	ph uu w a n a j^
ภูวนาถนรานุบาล	ph uu w a n aa t^ r aa n u b aa n^
ภูวปัญญาสิริ	ph uu w a p a n^ j aa s i r i
ภูวะปัจฉิม	ph uu w a p a t^ ch i m^
ภูอิทธิวงศ์	ph uu z i t^ th i w o ng^
ภูอุดม	ph uu z u d o m^
ภูแถวเชือก	ph uu th x w^ ch vva k^
ภูไท	ph uu th a j^
ภู่กันทอง	ph uu k a n^ th @@ ng^
ภู่จีนาพันธุ์	ph uu c ii n aa ph a n^
ภู่ทอง	ph uu th @@ ng^
ภู่ประดับศิลป์	ph uu pr a d a p^ s i n^
ภู่ประเสริฐ	ph uu pr a s qq t^
ภู่มาลี	ph uu m aa l ii
ภู่วรวรรณ	ph uu w @@ r a w a n^
ภู่วิจิตร	ph uu w i c i t^
ภู่สว่าง	ph uu s a w aa ng^
ภู่อารีย์	ph uu z aa r ii
ภู่เจริญยศ	ph uu c a r qq n^ j o t^
ภู่โอบอ้อม	ph uu z oo p^ z @@ m^
มกจ๊ก	m o k^ c o k^
มกรมณี	m a k a r a m a n ii
มกรานนท์	m a k a r aa n o n^
มงคลกิติ	m o ng^ kh o n^ k i t i
มงคลธรรม	m o ng^ kh o n^ th a m^
มงคลนาวิน	m o ng^ kh o n^ l a n aa w i n^
มงคลฤทธิ์	m o ng^ kh o n^ l a r i t^
มงคลลักษณ์	m o ng^ kh o n^ l a k^
มงคลวนิช	m o ng^ kh o n^ l a w a n i t^
มงคลศิริ	m o ng^ kh o n^ s i r i
มงคลสมัย	m o ng^ kh o n^ l a s a m a j^
มงคลสวัสดิ์	m o ng^ kh o n^ s a w a t^
มงคลสุข	m o ng^ kh o n^ s u k^
มงคลสุธี	m o ng^ kh o n^ s u th ii
มณฑีรรัตน์	m o n^ th ii r a r a t^
มณีกาศ	m a n ii k aa t^
มณีฉาย	m a n ii ch aa j^
มณีพันธุ์	m a n ii ph a n^
มณีรัตนะพร	m a n ii r a t^ t a n a ph @@ n^
มณีรัตน์	m a n ii r a t^
มณีวงษ์	m a n ii w o ng^
มณีวรรณ	m a n ii w a n^
มณีวรรณ์	m a n ii w a n^
มณีวัต	m a n ii w a t^
มณีสุข	m a n ii s u k^
มณีเทศ	m a n ii th ee t^
มนตริวัต	m o n^ tr i w a t^
มนตรีกุล	m o n^ tr ii k u n^
มนต์เสรีนุสรณ์	m o n^ s ee r ii n u s @@ n^
มนวิทูร	m o n^ w i th uu n^
มนะสิการ	m a n a s i k aa n^
มนัสพล	m a n a t^ s a ph o n^
มนิสสาร	m a n i t^ s aa n^
มนุญปิจุ	m a n u n^ p i c u
มนูญศิลป์	m a n uu n^ s i n^
มนูธรรม	m a n uu th a m^
มนูประเสริฐ	m a n uu pr a s qq t^
มนเทียรวิเชียรฉาย	m o n^ th iia n^ w i ch iia n^ ch aa j^
มยุรา	m a j u r aa
มยุรี	m a j u r ii
มรรคศศิธร	m a k^ s a s i th @@ n^
มรรยาทอ่อน	m a n^ j aa t^ z @@ n^
มฤคพิทักษ์	m a r v k^ kh a ph i th a k^
มหธร	m a h a th @@ n^
มหัตถพงศ์	m a h a t^ th a ph o ng^
มหากิจศิริ	m a h aa k i t^ c a s i r i
มหาดำรงค์กุล	m a h aa d a m^ r o ng^ k u n^
มหานนท์	m a h aa n o n^
มหาปราบ	m a h aa pr aa p^
มหาพฤกษ์พงศ์	m a h aa phr v k^ ph o ng^
มหาพิรุณ	m a h aa ph i r u n^
มหาภูมิพลอดุลยเดชมหาราช	m a h aa ph uu m i ph o n^ z a d u n^ j a d ee t^ m a h aa r aa t^
มหาวงศ์	m a h aa w o ng^
มหาวรรณ	m a h aa w a n^
มหาศรานนท์	m a h aa s a r aa n o n^
มหาสันทนะ	m a h aa s a n^ th a n a
มหาสุข	m a h aa s u k^
มหาสุวีระชัย	m a h aa s u w ii r a ch a j^
มหาเปารยะ	m a h aa p aa r a j a
มหาโยธารักษ์	m a h aa j oo th aa r a k^
มหิทธิ	m a h i t^ th i
มอนท์โกเมอรี่	m @@ n^ k oo m qq r ii
มอมขุนทด	m @ m^ kh u n^ th o t^
มอริสัน	m @@ r i s a n^
มอลลอย	m @@ l @@ j^
มะกูดี	m a k uu d ii
มะดากะกุล	m a d aa k a k u n^
มะทา	m a th aa
มะนาวหวาน	m a n aa w^ w aa n^
มะยุระ	m a j u r a
มะลิกุล	m a l i k u n^
มะลิซ้อน	m a l i s @@ n^
มะลูลีม	m a l uu l ii m^
มะหะหมัด	m a h a m a t^
มะโน	m a n oo
มะโนวร	m a n oo w @@ n^
มะโนแจ่ม	m a n oo c xx m^
มัครมย์	m a k^ kh a r o m^
มังคละพฤกษ์	m a ng^ kh a l a phr v k^
มังคลารัตน์	m a ng^ khl aa r a t^
มัจฉาชีพ	m a t^ ch aa ch ii p^
มัญชุรัตน์	m a n^ ch u r a t^
มัททวีวงศ์	m a t^ th a w ii w o ng^
มันตะลัมพะ	m a n^ t a l a m^ ph a
มันตาภรณ์	m a n^ t aa ph @@ n^
มัยลาภ	m a j^ j a l aa p^
มัสยวาณิช	m a t^ s a j a w aa n i t^
มั่งมี	m a ng^ m ii
มั่นกิจ	m a n^ k i t^
มั่นปาน	m a n^ p aa n^
มั่นหมาย	m a n^ m aa j^
มากบุญ	m aa k^ b u n^
มากเพชร	m aa k^ ph e t^
มากแสง	m aa k^ s xx ng^
มาตรทอง	m aa t^ th @@ ng^
มาตเจือ	m aa t^ c vva
มานะทัต	m aa n a th a t^
มานะพรชัย	m aa n a ph @@ n^ ch a j^
มานะยิ่ง	m aa n a j i ng^
มามีเกตุ	m aa m ii k ee t^
มารยาท	m aa r a j aa t^
มารศรี	m aa r a s ii
มารี	m aa r ii
มาร์	m aa
มาร์ติน	m aa t i n^
มาลัยพร	m aa l a j^ ph @@ n^
มาลากุล	m aa l aa k u n^
มาลาคำ	m aa l aa kh a m^
มาลานนท์	m aa l aa n o n^
มาลาพันธ์	m aa l aa ph a n^
มาลีนนท์	m aa l ii n o n^
มาศดิตถ์	m aa t^ d i t^
มาสุข	m aa s u k^
มาแสง	m aa s xx ng^
มาใช้เวทย์	m aa ch a j^ w ee t^
มิตรชัย	m i t^ ch a j^
มิตรธีรโรจน์	m i t^ tr a th ii r a r oo t^
มินทะขิน	m i n^ th a kh i n^
มินศิริ	m i n^ s i r i
มิลินทจินดา	m i l i n^ th a c i n^ d aa
มิเกล	m i k ee l^
มิเตอร์	m i t qq
มิ่งทุม	m i ng^ th u m^
มิ่งเชื้อ	m i ng^ ch vva
มิ้นซ์	m i n^
มีชัย	m ii ch a j^
มีชูธน	m ii ch uu th o n^
มีชูเวท	m ii ch uu w ee t^
มีทองคำ	m ii th @@ ng^ kh a m^
มีนชัยนันท์	m ii n^ ch a j^ n a n^
มีนะโยธิน	m ii n a j oo th i n^
มีบำรุง	m ii b a m^ r u ng^
มีประทัง	m ii pr a th a ng^
มีปรีชา	m ii pr ii ch aa
มีลาภ	m ii l aa p^
มีวุฒิสม	m ii w u t^ th i s o m^
มีสมสืบ	m ii s o m^ s vv p^
มีเพียร	m ii ph iia n^
มีเมฆ	m ii m ee k^
มีเรีย	m ii r iia
มีโชคชัย	m ii ch oo k^ ch a j^
มุกดา	m u k^ d aa
มุกดาสนิท	m u k^ d aa t^ s a n i t^
มุกดีพร้อม	m u k^ d ii phr @@ m^
มุตตามระ	m u t^ t aa m^ m a r a
มุตตาหารัช	m u t^ t aa h aa r a t^
มุทิรางกูร	m u th i r aa ng^ k uu n^
มุสิกพงศ์	m u s i k^ k a ph o ng^
มุสิกุล	m u s i k u n^
มุสิกโปดก	m u s i k^ p oo d o k^
มุ่งหมาย	m u ng^ m aa j^
มุ่งเจริญพร	m u ng^ c a r qq n^ ph @@ n^
มูลตรีพิลา	m uu n^ tr ii ph i l aa
มูลพินิจ	m uu n^ ph i n i t^
มูลมณี	m uu n^ m a n ii
มูลศาสตรสาทร	m uu n^ l a s aa t^ s aa th @@ n^
มูลศาสตร์	m uu n^ l a s aa t^
มูลสัน	m uu n^ s a n^
มโนบาล	m a n oo b aa n^
มโนมัยสันติภาพ	m a n oo m a j^ s a n^ t i ph aa p^
มโนเพ็ชร	m a n oo ph e t^
ม่วงงาม	m uua ng^ ng aa m^
ม่วงดี	m uua ng^ d ii
ม่วงบุญศรี	m uua ng^ b u n^ s ii
ม่วงมณี	m uua ng^ m a n ii
ม่วงศิริ	m uua ng^ s i r i
ม่วงแพรศรี	m uua ng^ phr xx s ii
ม่าเหร็ม	m aa r x m^
ม้ามณี	m aa m a n ii
ยงยุทธยิม	j o ng^ j u j i m^
ยงรัตนมงคล	j o ng^ r a t^ t a n a m o ng^ kh o n^
ยงสุวิมล	j o ng^ s u w i m o n^
ยงใจยุทธ	j o ng^ c a j^ j u t^
ยนตรกิจ	j o n^ tr a k i t^
ยนตรรักษ์	j o n^ r a k^
ยนต์ตระกูล	j o n^ tr a k uu n^
ยนต์โยธินกุล	j o n^ j oo th i n^ k u n^
ยมจินดา	j o m^ m a c i n^ d aa
ยมาภัย	j a m aa ph a j^
ยมเยี่ยม	j o m^ m a j iia m^
ยลระบิล	j o n^ r a b i n^
ยศ	j o t^
ยศสุข	j o t^ s u k^
ยศอมรสุนทร	j o t^ z a m @@ n^ s u n^ th @@ n^
ยศไกร	j o t^ kr a j^
ยอดกมล	j @@ t^ k a m o n^
ยอดญาติไทย	j @@ t^ j aa t^ th a j^
ยอดธนาสวัสดิ์	j @@ t^ th a n aa s a w a t^
ยอดนวล	j @@ t^ n uua n^
ยอดบัวงาม	j @@ t^ b uua ng aa m^
ยอดบางเตย	j @@ t^ b aa ng^ t qq j^
ยอดบุตร	j @@ t^ b u t^
ยอดปัญญา	j @@ t^ p a n^ j aa
ยอดพรหม	j @@ t^ phr o m^
ยอดพินิจ	j @@ t^ ph i n i t^
ยอดมณี	j @@ t^ m a n ii
ยอดเณร	j @@ t^ n ee n^
ยอดเมืองเจริญ	j @@ t^ m vva ng^ c a r qq n^
ยอดเศรณี	j @@ t^ s ee r a n ii
ยอดแก้ว	j @@ t^ k xx w^
ยอดไพสง	j @@ t^ ph a j^ s o ng^
ยะสวัสดิ์	j a s a w a t^
ยะสินธุ์	j a s i n^
ยัง	j a ng^
ยังตรง	j a ng^ tr o ng^
ยังเขียวสด	j a ng^ kh iia w^ s o t^
ยั่งยืน	j a ng^ j vv n^
ยานนาวา	j aa n^ n aa w aa
ยาประจันทร์	j aa pr a c a n^
ยาระณะ	j aa r a n a
ยาวอหะซัน	j aa w @@ h a s a n^
ยาวาหาบ	j aa w aa h aa p^
ยาและ	j aa l x
ยินดี	j i n^ d ii
ยิ่งยง	j i ng^ j o ng^
ยิ้มประเสริฐ	j i m^ pr a s qq t^
ยิ้มแย้ม	j i m^ j xx m^
ยืนยง	j vv n^ j o ng^
ยุกตะทัต	j u k a t a th a t^
ยุกตะนันท์	j u k a t a n a n^
ยุคล	j u kh o n^
ยุติธรรม	j u t^ t i th a m^
ยุทธการกำธร	j u t^ th a k aa n^ k a m^ th @@ n^
ยุทธกิจ	j u t^ th a k i t^
ยุทธพิชัย	j u t^ th a ph i ch a j^
ยุทธภัณฑ์บริภาร	j u t^ th a ph a n^ b @@ r i ph aa n^
ยุทธวงศ์	j u t^ th a w o ng^
ยุวบูรณ์	j u w a b uu n^
ยูซง	j uu t^ ng^
ยูวะนิยม	j uu w a n i j o m^
ยูวะเวส	j uu w a w ee t^
ยูสานนท์	j uu s aa n o n^
ยูโซ๊ะ	j uu s o
รงคผลิน	r o ng^ kh a phl i n^
รณนภากาศ	r o n^ n a n a ph aa k aa t^
รณภพ	r o n^ n a ph o p^
รณรงค์	r o n^ n a r o ng^
รณเกียรติ	r o n^ n a k iia t^
รดารงค์	r a d aa r o ng^
รติวัฒน์	r a t i w a t^
รพิพันธุ์	r a ph i ph a n^
รพีพัฒน์	r a ph ii ph a t^
รมยานนท์	r o m^ m a j aa n o n^
รสจันทน์	r o t^ c a n^
รสโอชา	r o t^ z oo ch aa
รองหานาม	r @@ ng^ h aa n aa m^
รองเงิน	r @@ ng^ ng q n^
รอดรักษา	r @@ t^ r a k^ s aa
รอดรัศมี	r @@ t^ r a t^ s a m ii
รอดศาสตรา	r @@ t^ s aa t^ tr aa
รอดเกิด	r @@ t^ k qq t^
รอดเพชร	r @@ t^ ph ee t^
รอดโพธิ์ทอง	r @@ t^ ph oo th @@ ng^
รอบคอบ	r @@ p^ kh @@ p^
รอส	r @@ t^
ระดมกิจ	r a d o m^ k i t^
ระดับปัญญาวุฒิ	r a d a p^ p a n^ j aa w u t^
ระวังป่า	r a w a ng^ p aa
ระหงษ์	r a h o ng^
รักกสิกรณ์	r a k^ k a s i k @@ n^
รักการดี	r a k^ k aa r a d ii
รักความสุข	r a k^ khw aa m^ s u k^
รักชีพ	r a k^ ch ii p^
รักตพงศ์ไพศาล	r a k^ t a ph o ng^ ph a j^ s aa n^
รักพงษ์อโศก	r a k^ ph o ng^ z a s oo k^
รักวานิช	r a k^ w aa n i t^
รักษนาเวส	r a k^ s a n aa w ee t^
รักษาพล	r a k^ s aa ph o n^
รักษาแก้ว	r a k^ s aa k xx w^
รักเกียรติยิม	r a k^ k iia t^ t i j i m^
รังคสิริ	r a ng^ kh a s i r i
รังคะรัตน	r a ng^ kh a r a t^
รังษีสิงห์พิพัฒน์	r a ng^ s ii s i ng^ ph i ph a t^
รังสิกุล	r a ng^ s i k u n^
รังสิตพล	r a ng^ s i t^ ph o n^
รังสิพราหมณกุล	r a ng^ s i phr aa m^ k u n^
รังสิโย	r a ng^ s i j oo
รังสี	r a ng^ s ii
รังสีธรรม	r a ng^ s ii th a m^
รัชกิจประการ	r a t^ ch a k i t^ pr a k aa n^
รัชตพันธุ	r a t^ ch a t a ph a n^ th u
รัชตะ	r a t^ ch a t a
รัชตะวรรณ	r a t^ ch a t a w a n^
รัชตเกรียงไกร	r a t^ ch a t a kr iia ng^ kr a j^
รัชนี	r a t^ ch a n ii
รัชนีกร	r a t^ ch a n ii k @@ n^
รัชย์จิราธรรม	r a t^ c i r aa th a m^
รัชเวทย์	r a t^ ch a w ee t^
รัฐประเสริฐ	r a t^ th a pr a s qq t^
รัฐผไท	r a t^ ph th a j^
รัฐไชย	r a t^ th a ch a j^
รัตกสิกร	r a t^ t a k a s i k @@ n^
รัตตกุล	r a t^ t a k u n^
รัตตนุสสรณ์	r a t^ t a n u s @@ s @@ n^
รัตตะกุญชร	r a t^ t a k u n^ ch @@ n^
รัตตะชัย	r a t^ t a ch a j^
รัตตัญญู	r a t^ t a n^ j uu
รัตนกิจไพศาล	r a t^ t a n a k i t^ ph a j^ s aa n^
รัตนกุล	r a t^ t a n a k u n^
รัตนคุณสาสน์	r a t^ t a n a kh u n^ n a s aa t^
รัตนฉายา	r a t^ t a n a ch aa j aa
รัตนชัยยิม	r a t^ t a n a ch a j^ j i m^
รัตนตั้งตระกูล	r a t^ t a n a t a ng^ tr a k uu n^
รัตนนิสสัย	r a t^ t a n a n i t^ s a j^
รัตนประชา	r a t^ t a n a pr a ch aa
รัตนพงษ์	r a t^ t a n a ph o ng^
รัตนพันธุ์	r a t^ t a n a ph a n^
รัตนพันธ์	r a t^ t a n a ph a n^
รัตนมาลากุล	r a t^ t a n a m aa l aa k u n^
รัตนรักษ์	r a t^ t a n a r a k^
รัตนรุ่งเรืองชัย	r a t^ t a n a r u ng^ r vva ng^ ch a j^
รัตนวราหะ	r a t^ t a n a w a r aa h a
รัตนวิเชียร	r a t^ t a n a w i ch iia n^
รัตนสัค	r a t^ t a n a s a k^
รัตนสุบรรณ	r a t^ t a n a s u b a n^
รัตนสุวรรณ	r a t^ t a n a s u w a n^
รัตนหรูวิจิตร	r a t^ t a n a r uu w i c i t^
รัตนอุดม	r a t^ t a n a z u d o m^
รัตนอุบล	r a t^ t a n a z u b o n^
รัตนะ	r a t^ t a n a
รัตนะรัต	r a t^ t a n a r a t^
รัตนะสิทธิ์	r a t^ t a n a s i t^
รัตนัง	r a t^ t a n a ng^
รัตนากร	r a t^ t a n aa k @@ n^
รัตนาไพศาลสุข	r a t^ t a n aa ph a j^ s aa n^ s u k^
รัตนเพียร	r a t^ t a n a ph iia n^
รัตนเมธานนท์	r a t^ t a n a m ee th aa n o n^
รัตนเรือง	r a t^ t a n a r vva ng^
รัตนเรืองวัฒนา	r a t^ t a n a r vva ng^ w a t^ th a n aa
รัตนเศรษฐ	r a t^ t a n a s ee t^
รัตนเสถียร	r a t^ t a n a s a th iia n^
รัตนเสวี	r a t^ t a n a s ee w ii
รัตนแสงสรวง	r a t^ t a n a s xx ng^ s uua ng^
รัตนโกเศศ	r a t^ t a n a k oo s ee t^
รัตนโชติ	r a t^ t a n a ch oo t^
รัตนโภคาสถิต	r a t^ t a n a ph oo k^ k a w^ s a th i t^
รัตนโสภา	r a t^ t a n a s oo ph aa
รัตน์วงศ์สกุล	r a t^ w o ng^ s a k u n^
รัศมิทัต	r a t^ s a m i th a t^
รากะรินทร์	r aa k a r i n^
รากแก่น	r aa k^ k xx n^
ราชกรม	r aa t^ ch a kr o m^
ราชนิยม	r aa t^ ch a n i j o m^
ราชปาล	r aa t^ ch a p aa n^
ราชป้องขันธ์	r aa t^ ch a p @ ng^ kh a n^
ราชพงษ์	r aa t^ ch a ph o ng^
ราชพลสิทธิ์	r aa t^ ch a ph o n^ l a s i t^
ราชวัฏ	r aa t^ ch a w a t^
ราชวัตร	r aa t^ ch a w a t^
ราชสีมา	r aa t^ ch a s ii m aa
ราชสีห์	r aa t^ ch a s ii
ราชอาภัย	r aa t^ ch a z aa ph a j^
ราชานนท์	r aa ch aa n o n^
รามณรงค์	r aa m^ n a r o ng^
รามสูต	r aa m^ m a s uu t^
รามางกูร	r aa m aa ng^ k uu n^
รายยวา	r aa j^ j a w aa
ราศีธนู	r aa s ii th a n uu
ราษฎร์จำเริญสุข	r aa t^ c a m^ r qq n^ s u k^
ราษีจันทร์	r aa s ii c a n^
ราฮิมมูลา	r aa h i m^ m uu l aa
รินคำ	r i n^ kh a m^
รินทรวิฑูรย์	r i n^ w i th uu n^
ริ้วตระกูล	r i w^ tr a k uu n^
รีส	r ii s^
รื่นเริง	r vv n^ r qq ng^
รุจนเสรี	r u c a n a s ee r ii
รุจินานนท์	r u c i n aa n o n^
รุจิพรรณ	r u c i ph a n^
รุจิรวงศ์	r u c i r a w o ng^
รุจิระชาคร	r u c i r a ch aa kh @@ n^
รุจิราภา	r u c i r aa ph aa
รุจิเรข	r u c i r ee k^
รุมาคม	r u m aa kh o m^
รุ่งธนเกียรติ	r u ng^ th a n a k iia t^
รุ่งนพคุณศรี	r u ng^ n o p^ ph a kh u n^ n a s ii
รุ่งพาณิชย์	r u ng^ ph aa n i t^
รุ่งรัตน์	r u ng^ r a t^
รุ่งวิจิตรชัย	r u ng^ w i c i t^ ch a j^
รุ่งวิสัย	r u ng^ w i s a j^
รุ่งสว่าง	r u ng^ s a w aa ng^
รุ่งสาคร	r u ng^ s aa kh @@ n^
รุ่งเรือง	r u ng^ r vva ng^
รุ่งแสง	r u ng^ s xx ng^
รุ่งโพธิ์ทอง	r u ng^ ph oo th @@ ng^
รุ่งโรจน์	r u ng^ r oo t^
รูปขจร	r uu p^ kh a c @@ n^
รู้ธรรม	r uu th a m^
ร่มเย็น	r o m^ j e n^
ฤกษ์ธำรงค์	r qq k^ th a m^ r o ng^
ฤกษ์หร่าย	r qq k^ r aa j^
ฤกษ์อัตการ	r qq k^ z a t^ t a k aa n^
ฤชุพันธุ์	r v ch u ph a n^
ฤทธาคนี	r i t^ th aa k^ kh a n ii
ฤทธิชัย	r i t^ th i ch a j^
ฤทธินาคา	r i t^ th i n aa kh aa
ฤทธิมณี	r i t^ th i m a n ii
ฤทธิไกร	r i t^ th i kr a j^
ฤทธิ์ถกล	r i t^ th a k o n^
ฤทธิ์ธาอภินันท์	r i t^ th aa z a ph i n a n^
ลพานุกรม	l a ph aa n u kr o m^
ลอพันธุ์ไพบูลย์	l @@ ph a n^ ph a j^ b uu n^
ลอยชูศักดิ์	l @@ j^ ch uu s a k^
ลอยด์	l @@ j^
ละครพล	l a kh @@ n^ ph o n^
ละอองมณี	l a z @@ ng^ m a n ii
ละอองสุวรรณ	l a z @@ ng^ s u w a n^
ละไล	l a l a j^
ลักษณวิศิษฎ์	l a k^ s a n a w i s i t^
ลักษมีพงศ์	l a k^ s a m ii ph o ng^
ลังกาวงษ์	l a ng^ k aa w o ng^
ลัดดาชยาพร	l a t^ d aa ch a j aa ph @@ n^
ลัทธพิพัฒน์	l a t^ th a ph i ph a t^
ลัทธศักดิ์ศิริ	l a t^ th a s a k^ s i r i
ลัม	l a m^
ลัมมะกานนท์	l a m^ m a k aa n o n^
ลาชโรจน์	l aa t^ ch a r oo t^
ลาภมาก	l aa p^ m aa k^
ลาภวิสุทธิสิน	l aa p^ w i s u t^ th i s i n^
ลาภาโรจน์กิจ	l aa ph aa r oo t^ k i t^
ลาภเจริญทรัพย์	l aa p^ c a r qq n^ s a p^
ลายถมยา	l aa j^ th o m^ m a j aa
ลาร์เซ่น	l aa s e n^
ลาวัณย์ประเสริฐ	l aa w a n^ pr a s qq t^
ลาวัณย์ศิริ	l aa w a n^ s i r i
ลาวัลย์ชัยกุล	l aa w a n^ ch a j^ k u n^
ลาเทศ	l aa th ee t^
ลาโคนิคส์	l aa kh oo n i k^
ลาโพธิ์	l aa ph oo
ลำพระเพลิง	l a m^ phr a phl qq ng^
ลำพูน	l a m^ ph uu n^
ลิกค์	l i k^
ลิขิตกุล	l i kh i t^ k u n^
ลิขิตจิตถะ	l i kh i t^ c i t^ th a
ลิปตพัลลภ	l i p^ p a t a ph a n^ l o p^
ลิมปคุปตถาวร	l i m^ p a kh u p^ th aa w @@ n^
ลิมปพัทธ์	l i m^ p a ph a t^
ลิมปยารยะ	l i m^ p a j aa r a j a
ลิมปรังษี	l i m^ r a ng^ s ii
ลิมปวุฒิวรานนท์	l i m^ p a w u t^ th i w a r aa n o n^
ลิมปะพันธุ์	l i m^ p a ph a n^
ลิมปิสวัสดิ์	l i m^ p i s a w a t^
ลิมศนุกาญจน์	l i m^ s a n u k aa n^
ลิละคร	l i l a kh @@ n^
ลิโพวิตันดี	l i ph oo w i t a n^ d ii
ลิ่มรัตนะมงคล	l i m^ r a t^ t a n a m o ng^ kh o n^
ลิ่มสกุล	l i m^ s a k u n^
ลิ่วลักษณ์	l i w^ l a k^
ลิ่วเฉลิมวงศ์	l i w^ ch a l qq m^ w o ng^
ลิ้มตระกูล	l i m^ tr a k uu n^
ลิ้มทองกุล	l i m^ th @@ ng^ k u n^
ลิ้มธรรมมหิศร	l i m^ th a m^ m a m a h i s @@ n^
ลิ้มรักษา	l i m^ r a k^ s aa
ลิ้มวรรณเสถียร	l i m^ w a n^ n a s a th iia n^
ลิ้มวัฒนะ	l i m^ w a t^ th a n a
ลิ้มเจริญ	l i m^ c a r qq n^
ลิ้มแหลมทอง	l i m^ l xx m^ th @@ ng^
ลี	l ii
ลีกิจวัฒนะ	l ii k i t^ c a w a t^ th a n a
ลีติกุล	l ii t i k u n^
ลีธีระประเสริฐ	l ii th ii r a pr a s qq t^
ลีนานนท์	l ii n aa n o n^
ลีนุตพงษ์	l ii n u t^ t a ph o ng^
ลียะวณิช	l ii j a w a n i t^
ลีรัตนขจร	l ii r a t^ t a n a kh a c @@ n^
ลีละพงศ์ประสุต	l ii l a ph o ng^ pr a s u t^
ลีละเศรษฐกุล	l ii l a s ee t^ th a k u n^
ลีวงษ์ษา	l ii w o ng^ s aa
ลีวิส	l ii w i t^
ลีวิโรจน์	l ii w i r oo t^
ลีสวัสดิ์ตระกูล	l ii s a w a t^ tr a k uu n^
ลีห์อร่ามวัฒน์	l ii z a r aa m^ w a t^
ลีเอาะ	l ii z @
ลี่	l ii
ลี้ชัยพรกุล	l ii ch a j^ ph @@ n^ k u n^
ลี้สุวรรณ	l ii s u w a n^
ลี้อนันต์ศักดิ์ศิริ	l ii z a n a n^ s a k^ s i r i
ลือกาญจนวนิช	l vv k aa n^ c a n a w a n i t^
ลือชัย	l vv ch a j^
ลือชา	l vv ch aa
ลือประเสริฐ	l vv pr a s qq t^
ลือวิเศษไพบูลย์	l vv w i s ee t^ ph a j^ b uu n^
ลืออดุลย์	l vv z a d u n^
ลุดวิก	l u t^ w i k^
ลุนด์เบิร์ก	l u n^ b qq k^
ลุนเผ่	l u n^ ph ee
ลูกจันทร์	l uu k^ c a n^
ลูกทรายกองดิน	l uu k^ s aa j^ k @@ ng^ d i n^
ลูกบุญมี	l uu k^ b u n^ m ii
ลูกบ้านใหญ่	l uu k^ b aa n^ j a j^
ลูกปัญจมา	l uu k^ p a n^ c a m aa
ลูกพระกฤษณ์	l uu k^ phr a kr i t^
ลูกพระบาท	l uu k^ phr a b aa t^
ลูกมาตุลี	l uu k^ m aa t u l ii
ลูกมิ่งขวัญ	l uu k^ m i ng^ khw a n^
ลูกราชบุรี	l uu k^ r aa t^ ch a b u r ii
ลูกลำผักชี	l uu k^ l a m^ ph a k^ ch ii
ลูกวิเศษ	l uu k^ w i s ee t^
ลูกศิริพัฒน์	l uu k^ s i r i ph a t^
ลูกหนองไก่ขัน	l uu k^ n @@ ng^ k a j^ kh a n^
ลูกเจ้าแม่สายวารี	l uu k^ c a w^ m xx s aa j^ w aa r ii
ลูกเพชร	l uu k^ ph e t^
ล่าทา	l aa th aa
ล่ำซำ	l a m^ s a m^
ล้อเหล็ก	l @@ l e k^
วงค์ษาแจ่ม	w o ng^ s aa c xx m^
วงค์เทียนชัย	w o ng^ th iia n^ ch a j^
วงทอง	w o ng^ th @@ ng^
วงมา	w o ng^ m aa
วงวัฒน์	w o ng^ w a t^
วงศารัตนศิลป์	w o ng^ s aa r a t^ t a n a s i n^
วงศ์	w o ng^
วงศ์กำแหง	w o ng^ k a m^ h xx ng^
วงศ์ขจรไกล	w o ng^ kh a c @@ n^ kl a j^
วงศ์ฉลาด	w o ng^ ch a l aa t^
วงศ์ทอง	w o ng^ th @@ ng^
วงศ์ทองศรี	w o ng^ th @@ ng^ s ii
วงศ์นาค	w o ng^ n aa k^
วงศ์บุญ	w o ng^ b u n^
วงศ์ประเสริฐ	w o ng^ pr a s qq t^
วงศ์ผู้ดี	w o ng^ ph uu d ii
วงศ์พัฒนกิจ	w o ng^ ph a t^ th a n a k i t^
วงศ์พัวพันธ์	w o ng^ ph uua ph a n^
วงศ์ภูมิ	w o ng^ ph uu m^
วงศ์มีมา	w o ng^ m ii m aa
วงศ์ยา	w o ng^ j aa
วงศ์รักมิตร	w o ng^ r a k^ m i t^
วงศ์รัตนวรรณ	w o ng^ r a t^ t a n a w a n^
วงศ์ลือเกียรติ	w o ng^ l vva k iia t^
วงศ์วชิราภักดิ์	w o ng^ w a ch i r aa ph a k^
วงศ์วรรณ	w o ng^ w a n^
วงศ์วรโชติ	w o ng^ w @@ r a ch oo t^
วงศ์วาสนา	w o ng^ w aa t^ s a n aa
วงศ์วิทยานันท์	w o ng^ w i t^ th a j aa n a n^
วงศ์วิริยะ	w o ng^ w i r i j a
วงศ์วิลาศ	w o ng^ w i l aa t^
วงศ์วิโรจน์	w o ng^ w i r oo t^
วงศ์ศรีวงศ์	w o ng^ s ii w o ng^
วงศ์ศิริ	w o ng^ s i r i
วงศ์ศุภลักษณ์	w o ng^ s u p^ ph a l a k^
วงศ์ษา	w o ng^ s aa
วงศ์สมบูรณ์	w o ng^ s o m^ b uu n^
วงศ์สมุทร	w o ng^ s a m u t^
วงศ์สวัสดิ์	w o ng^ s a w a t^
วงศ์สว่าง	w o ng^ s a w aa ng^
วงศ์สุรวัฒน์	w o ng^ s u r a w a t^
วงศ์สุวรรณ	w o ng^ s u w a n^
วงศ์หนองเตย	w o ng^ n @@ ng^ t qq j^
วงศ์อัครากุล	w o ng^ z a k^ kh a r aa k u n^
วงศ์อารยะ	w o ng^ z aa r a j a
วงศ์เทวัญ	w o ng^ th ee w a n^
วงศ์เทเวศร์	w o ng^ th ee w ee t^
วงศ์เบี้ยสัจจ์	w o ng^ b iia s a t^
วงศ์โฆษวรรณ	w o ng^ kh oo t^ s a w a n^
วงศ์ไชย	w o ng^ ch a j^
วงศ์ไตรรัตน์	w o ng^ tr a j^ r a t^
วงษ์กรณ์	w o ng^ k @@ n^
วงษ์กระจ่าง	w o ng^ kr a c aa ng^
วงษ์งาม	w o ng^ ng aa m^
วงษ์จินดา	w o ng^ c i n^ d aa
วงษ์ชาลี	w o ng^ ch aa l ii
วงษ์ตระหง่าน	w o ng^ tr a ng aa n^
วงษ์ประยูร	w o ng^ pr a j uu n^
วงษ์ประเทศ	w o ng^ pr a th ee t^
วงษ์มณฑา	w o ng^ m o n^ th aa
วงษ์สนิท	w o ng^ s a n i t^
วงษ์สวรรค์	w o ng^ s a w a n^
วงษ์สำราญ	w o ng^ s a m^ r aa n^
วงษ์สุนทร	w o ng^ s u n^ th @@ n^
วงษ์สุวรรณ	w o ng^ s u w a n^
วงษ์เดอรี	w o ng^ d qq r ii
วงษ์เทศ	w o ng^ th ee t^
วงษ์แก้ว	w o ng^ k xx w^
วงษ์ไกร	w o ng^ kr a j^
วงษ์ไชยา	w o ng^ ch a j^ j aa
วจนานนท์	w a c a n aa n o n^
วชิรธรรมพร	w a ch i r a th a m^ m a ph @@ n^
วชิรบรรจง	w a ch i r a b a n^ c o ng^
วชิรบาล	w a ch i r a b aa n^
วชิรปิลันธิ์	w a ch i r a p i l a n^
วชิรพงศ์	w a ch i r a ph o ng^
วชิรมโนวงศ์	w a ch i r a m a n oo w o ng^
วชิรรัตนวงศ์	w a ch i r a r a t^ t a n a w o ng^
วชิรเมธี	w a ch i r a m ee th ii
วณิชนันทธาดา	w a n i t^ ch a n a n^ th a th aa d aa
วทัญญุตาพงศ์	w a th a n^ j u t aa ph o ng^
วนา	w a n aa
วนิชจิวพันธ์	w a n i t^ c i w^ w a ph a n^
วนิดา	w a n i d aa
วรงคไพสิฐ	w @@ r a ng o k^ ph a j^ s i t^
วรฉัตร	w @@ r a ch a t^
วรดิลก	w @@ r a d i l o k^
วรธรรม	w @@ r a th a m^
วรนุช	w @@ r a n u t^
วรปัญญา	w @@ r a p a n^ j aa
วรพฤทธานนท์	w @@ n^ phr v t^ th aa n o n^
วรพัฒนานันน์	w @@ r a ph a t^ th a n aa n a n^
วรภิรมย์รักษ์	w @@ r a ph i r o m^ r a k^
วรรณกิจ	w a n^ n a k i t^
วรรณบวร	w a n^ b @@ z^0 w @@ n^
วรรณปก	w a n^ n a p o k^
วรรณปกาสิต	w a n^ n a p a k aa s i t^
วรรณรัตน์	w a n^ n a r a t^
วรรณวินเวศร์	w a n^ n a w i n^ w ee t^
วรรณศรี	w a n^ n a s ii
วรรณศิริกุล	w a n^ n a s i r i k u n^
วรรณสถิตย์	w a n^ s a th i t^
วรรณสุข	w a n^ n a s u k^
วรรณสุทธิ์	w a n^ n a s u t^
วรรณอรุณ	w a n^ n a z a r u n^
วรรณานนท์	w a n^ n aa n o n^
วรรณึกกุล	w a n^ v k^ k u n^
วรรณแสง	w a n^ n a s xx ng^
วรรณโชติ	w a n^ n a ch oo t^
วรรธนะสิน	w a t^ th a n a s i n^
วรรัตนาชัย	w @@ r a r a t^ t a n aa ch a j^
วรวรรณ	w @@ r a w a n^
วรวัลย์	w @@ r a w a n^
วรวิจิตรชัยกุล	w @@ r a w i c i t^ ch a j^ k u n^
วรวินิต	w @@ r a w i n i t^
วรวุฒิ	w @@ r a w u t^
วรอุไร	w @@ r a z u r a j^
วรัญญา	w a r a n^ j aa
วรากุลนุเคราะห์	w a r aa k u n^ n u khr @
วรเชษฐ์	w @@ r a ch ee t^
วลัยเสถียร	w a l a j^ s a th iia n^
วศินสังวร	w a s i n a s a ng^ w @@ n^
วสยางกูร	w a s a j aa ng^ k uu n^
วสุวัต	w a s u w a t^
วสุไกรไพศาล	w a s u kr a j^ ph a j^ s aa n^
วอกลาง	w @@ kl aa ng^
วอกอร์ด	w @@ k @@ t^
วอลช	w @@ l^ ch^
วอลเลอร์	w @@ l^ l qq
วอเทียร์	w @@ th iia
วะสี	w a s ii
วะสีนนท์	w a s ii n o n^
วะโฮรัมย์	w a h oo r a m^
วังฆะฮาด	w a ng^ kh a h aa t^
วังจันทร์	w a ng^ c a n^
วังทะพันธ์	w a ng^ th a ph a n^
วังสวัสดิ์	w a ng^ s a w a t^
วัชรคุณ	w a t^ ch a r a kh u n^
วัชรตระกูล	w a t^ ch a r a tr a k uu n^
วัชรทัศนกุล	w a t^ ch a r a th a t^ s a n a k u n^
วัชรพล	w a t^ ch a r a ph o n^
วัชรพุกก์	w a t^ ch a r a ph u k^
วัชรวิทย์	w a t^ ch a r a w i t^
วัชรสวัสดิ์	w a t^ s a w a t^
วัชรสินธุ	w a t^ ch a r a s i n^
วัชรา	w a t^ ch a r aa
วัชรานนท์	w a t^ ch a r aa n o n^
วัชรานันท์	w a t^ ch a r aa n a n^
วัชราพลเมฆ	w a t^ ch a r aa ph o n^ l a m ee k^
วัชราภรณ์	w a t^ ch a r aa ph @@ n^
วัชรเสวี	w a t^ ch a r a s ee w ii
วัชโรทัย	w a t^ ch a r oo th a j^
วัชโรบล	w a t^ ch a r oo b o n^
วัฏลีลา	w a t^ t a l ii l aa
วัฒฐานะ	w a t^ th a th aa n a
วัฒนกิติพัฒน์	w a t^ th a n a k i t i ph a t^
วัฒนกุล	w a t^ th a n a k u n^
วัฒนคุณ	w a t^ th a n a kh u n^
วัฒนจัง	w a t^ th a n a c a ng^
วัฒนจินดา	w a t^ th a n a c i n^ d aa
วัฒนชัย	w a t^ th a n a ch a j^
วัฒนชาติวงศ์	w a t^ th a n a ch aa t^ w o ng^
วัฒนธรรม	w a t^ th a n a th a m^
วัฒนพงศ์	w a t^ th a n a ph o ng^
วัฒนพงศ์ศิริ	w a t^ th a n a ph o ng^ s i r i
วัฒนพานิช	w a t^ th a n a ph aa n i t^
วัฒนวรากุล	w a t^ th a n a w a r aa k u n^
วัฒนศิริธรรม	w a t^ th a n a s i r i th a m^
วัฒนสิงหะ	w a t^ th a n a s i ng^ h a
วัฒนสินธุ์	w a t^ th a n a s i n^
วัฒนสุชาติ	w a t^ th a n a s u ch aa t^
วัฒนะ	w a t^ th a n a
วัฒนา	w a t^ th a n aa
วัฒนากมลวุฒิ	w a t^ th a n aa k a m o n^ w u t^
วัฒนากสิกรรม	w a t^ th a n aa k a s i k a m^
วัฒนากุล	w a t^ th a n aa k u n^
วัฒนางกูร	w a t^ th a n aa ng^ k uu n^
วัฒนานุกูล	w a t^ th a n aa n u k uu n^
วัฒนามนตรี	w a t^ th a n aa m o n^ tr ii
วัฒนายากร	w a t^ th a n aa j aa k @@ n^
วัฒนเกส	w a t^ th a n a k ee t^
วัฒนเศรษสิริ	w a t^ th a n a s ee t^ s i r i
วัฒนโกเมร	w a t^ th a n a k oo m ee n^
วัฒนไกร	w a t^ th a n a kr a j^
วัฒโรดม	w a t^ th a r oo d o m^
วัณโณ	w a n^ n a n oo
วัดหนู	w a t^ n uu
วัดอักษร	w a t^ z a k^ s @@ n^
วัดอิ่ม	w a t^ z i m^
วัธนวงส์ศิริ	w a t^ th a n a w o ng^ s i r i
วัธนเวคิน	w a t^ th a n a w ee kh i n^
วันทนา	w a n^ th a n aa
วันทองทักษ์	w a n^ th @@ ng^ th a k^
วันสว่าง	w a n^ s a w aa ng^
วันไชยธนวงศ์	w a n^ ch a j^ th a n a w o ng^
วัลลิโภดม	w a n^ l i ph oo d o m^
วาณิชย์กุล	w aa n i t^ k u n^
วาณิชวิวัฒน์	w aa n i t^ w i w a t^
วาทิตตพันธ์	w aa th i t^ t a ph a n^
วานิช	w aa n i t^
วารายานนท์	w aa r aa j aa n o n^
วารินรักษ์	w aa r i n^ r a k^
วาร์นี	w aa n ii
วาศนาส่ง	w aa t^ s a n aa s o ng^
วาศภูติ	w aa t^ ph uu t^
วิกรานต์	w i kr aa n^
วิกิตเศรษฐ์	w i k i t^ s ee t^
วิจักษณบุญ	w i c a k^ s a n a b u n^
วิจารณ์ณรงค์	w i c aa n^ n a r o ng^
วิจารณ์ปรีชา	w i c aa n^ pr ii ch aa
วิจิตรวงศ์ทอง	w i c i tr uua ng^ th @@ ng^
วิจิตรานนท์	w i c i t^ tr aa n o n^
วิจิตสาร	w i c i t^ s aa n^
วิจินธนสาร	w i c i n^ th a n a s aa n^
วิชย	w i t^ ch a j a
วิชยสุทธิ์	w i t^ ch a j a s u t^
วิชัยกุล	w i ch a j^ k u n^
วิชัยดิษฐ	w i ch a j^ d i t^
วิชัยลักษณ์	w i ch a j^ l a k^
วิชิตชลชัย	w i ch i t^ ch o n^ ch a j^
วิถี	w i th ii
วิถีชัย	w i th ii ch a j^
วิทยถาวรวงศ์	w i t^ th a j a th aa w @@ n^ w o ng^
วิทยวิโรจน์	w i t^ th a j a w i r oo t^
วิทยากาศ	w i t^ th a j aa k aa t^
วิทยานนท์	w i t^ th a j aa n o n^
วิทยาปัญญานนท์	w i t^ th a j aa p a n^ j aa n o n^
วิทวัส	w i t^ th a w a t^
วิทิตศานต์	w i th i t^ s aa n^
วิน	w i n^
วินัยพานิช	w i n a j^ ph aa n i t^
วินิจจะกูล	w i n i t^ c a k uu n^
วินิจฉัยกุล	w i n i t^ ch a j^ k u n^
วิบูลย์ชัย	w i b uu n^ ch a j^
วิบูลย์สวัสดิ์	w i b uu n^ s a w a t^
วิปุลากร	w i p u l aa k @@ n^
วิพรหมชัย	w i phr o m^ ch a j^
วิพัธครตระกูล	w i ph a t^ khr tr a k uu n^
วิภัติภูมิประเทศ	w i ph a t^ ph uu m i pr a th ee t^
วิภูศิริ	w i ph uu s i r i
วิมลโนช	w i m o n^ n oo t^
วิมุกตายน	w i m u k^ t aa j o n^
วิมุตตานนท์	w i m u t^ t aa n o n^
วิรัชชัย	w i r a t^ ch a j^
วิรัชประเสริฐ	w i r a t^ pr a s qq t^
วิรัฐถาวร	w i r a t^ th a th aa w @@ n^
วิรัตน์จันทร์	w i r a t^ c a n^
วิริยะชัย	w i r i j a ch a j^
วิริยะชัยกิจ	w i r i j a ch a j^ k i t^
วิริยะบำรุงกิจ	w i r i j a b a m^ r u ng^ k i t^
วิริยะพงศ์ชัย	w i r i j a ph o ng^ ch a j^
วิริยะพานิช	w i r i j a ph aa n i t^
วิริยะอุดมศิริ	w i r i j a z u d o m^ s i r i
วิริยะเมตตากุล	w i r i j a m ee t^ t aa k u n^
วิริยะโรจน์	w i r i j a r oo t^
วิริยางกูร	w i r i j aa ng^ k uu n^
วิรุฬหมาศ	w i r u n^ m aa t^
วิลล์	w i l^
วิลาวัลย์	w i l aa w a n^
วิวรรธนดิฐกุล	w i w a t^ d i t^ k u n^
วิวรรธนวรางค์	w i w a t^ th a n a w a r aa ng^
วิวัชรวงศ์	w i w a t^ ch a r a w o ng^
วิวัฒน์ชัยโชค	w i w a t^ ch a j^ ch oo k^
วิวัธนชัย	w i w a t^ th a n a ch a j^
วิศิษฐ์กิจการ	w i s i t^ k i t^ c a k aa n^
วิศุภกาญจน์	w i s u p^ ph a k aa n^
วิษณุ	w i t^ s a n u
วิสมล	w i t^ s a m o n^
วิสมิตะนันทน์	w i t^ s a m i t a n a n^
วิสัยจร	w i s a j^ c @@ n^
วิสาโล	w i s aa l oo
วิสิฐไวทยากุล	w i s i t^ w a j^ th a j aa k u n^
วิสิษฐยุทธศาสตร์	w i s i t^ j u t^ th a s aa t^
วิสุทธิธาดา	w i s u t^ th i th aa d aa
วิสุทธิปราณี	w i s u t^ th i pr aa n ii
วิสุทธิ์	w i s u t^
วิสูตรโยธาภิบาล	ดิษฐ์ w i s uu t^ tr a j oo th aa ph i b aa n^
วิหครัตน์	w i h o k^ r a t^
วิเชียรเจริญ	w i ch iia n^ c a r qq n^
วิเลปะนะ	w i l ee p a n a
วิเศษกุล	w i s ee t^ k u n^
วิเศษศรี	w i s ee t^ s ii
วิเศษสมบัติ	w i s ee t^ s o m^ b a t^
วิเศษสุวรรณภูมิ	w i s ee t^ s u w a n^ n a ph uu m^
วิเศษแก้ว	w i s ee t^ k xx w^
วิโนทัย	w i n oo th a j^
วิไลลักษณ์	w i l a j^ l a k^
วิไลศักดิ์	w i l a j^ s a k^
วิไลโรจน์	w i l a j^ r oo t^
วี	w ii
วีรยวรรธน	w ii r a j a w a t^
วีรวรรณ	w ii r a w a n^
วีรวัฒโนดม	w ii r a w a t^ th a n oo d o m^
วีระกุล	w ii r a k u n^
วีระชาติ	w ii r a ch aa t^
วีระพงษ์	w ii r a ph o ng^
วีระพล	w ii r a ph o n^
วีระพันธุ์	w ii r a ph a n^
วีระยุทธวิไล	w ii r a j u t^ th a w i l a j^
วีระศักดิ์เล็ก	w ii r a s a k^ l e k^
วีระอนันตวัฒน์	w ii r a z a n a n^ t a w a t^
วีระเมธีกุล	w ii r a m ee th ii k u n^
วีระเศรษฐกุล	w ii r a s ee t^ th a k u n^
วีระไวทยะ	w ii r a w a j^ th a j a
วีรานุกูล	w ii r aa n u k uu n^
วีละวง	w ii l a w o ng^
วีสมหมาย	w ii s o m^ m aa j^
วุฑฒิปรีชา	w u t^ th i pr ii ch aa
วุฑฒิโชติ	w u t^ th i ch oo t^
วุฒิชัยประดิษฐ์	w u t^ th i ch a j^ pr a d i t^
วุฒิธรรม	w u t^ th i th a m^
วุฒินันชัย	w u t^ th i n a n^ ch a j^
วุฒิศิริ	w u t^ th i s i r i
วุฒิเลิศ	w u t^ th i l qq t^
ว่องกุศลกิจ	w @@ ng^ k u s o n^ l a k i t^
ว่องชยาภรณ์	w @@ ng^ ch a j aa ph @@ n^
ว่องตระกูล	w @@ ng^ tr a k uu n^
ว่องวานิช	w @@ ng^ w aa n i t^
ศกุนตนิยม	s a k u n^ t a n i j o m^
ศตายุ	s a t aa j u
ศรชัย	s @@ n^ ch a j^
ศรณ์อัครภา	s @@ n^ z a k^ kh a r a ph aa
ศรทองยิม	s @@ n^ th @@ ng^ j i m^
ศรนรินทร์	s @@ n^ n a r i n^
ศรลัมพ์	s @@ n^ r a l a m^
ศรสงคราม	s @@ n^ s o ng^ khr aa m^
ศรสุพรรณ	s @@ n^ s u ph a n^
ศรัณย์ศิขริน	s a r a n^ s i kh a r i n^
ศรัณย์เกตุ	s a r a n^ k ee t^
ศรินทุ	s a r i n^ th u
ศรีกรานนท์	s ii kr aa n o n^
ศรีกลิ่นดี	s ii kl i n^ d ii
ศรีงาม	s ii ng aa m^
ศรีจรูญ	s ii c a r uu n^
ศรีจุมพล	s ii c u m^ ph o n^
ศรีชล	s ii ch o n^
ศรีชาพันธุ์	s ii ch aa ph a n^
ศรีชาหลวง	s ii ch aa l uua ng^
ศรีดารุณศีล	s ii d aa r u n^ n a s ii n^
ศรีดี	s ii d ii
ศรีดุรงคธรรมพ์	s ii d u r o ng^ kh a th a m^
ศรีตรัง	s ii tr a ng^
ศรีตะลา	s ii t a l aa
ศรีทอง	s ii th @@ ng^
ศรีทองดี	s ii th @@ ng^ d ii
ศรีทองอินทร์	s ii th @@ ng^ z i n^
ศรีทะโร	s ii th a r oo
ศรีธวัช	s ii th a w a t^
ศรีธเรศ	s ii th a r ee t^
ศรีนนท์	s ii n o n^
ศรีนอก	s ii n @@ k^
ศรีนาคา	s ii n aa kh aa
ศรีนาวงษ์	s ii n aa w o ng^
ศรีบรรจง	s ii b a n^ c o ng^
ศรีบุญเรือง	s ii b u n^ r vva ng^
ศรีบุตร	s ii b u t^
ศรีปฎิมากูร	s ii p a d i m aa k uu n^
ศรีประจวบ	s ii pr a c uua p^
ศรีประจันต์	s ii pr a c a n^
ศรีประเสริฐ	s ii pr a s qq t^
ศรีปัญญา	s ii p a n^ j aa
ศรีปาน	s ii p aa n^
ศรีปินตา	s ii p i n^ t aa
ศรีพรหม	s ii phr o m^
ศรีพัชรินทรมาตา	s ii ph a t^ ch a r i n^ th @@ n^ m aa t aa
ศรีพานิช	s ii ph aa n i t^
ศรีฟ้า	s ii f aa
ศรีภิรมย์	s ii ph i r o m^
ศรีภูมิเศรษฐ์	s ii ph uu m^ s ee t^
ศรีมณี	s ii m a n ii
ศรีมะฆะ	s ii m a kh a
ศรีมั่นคงธรรม	s ii m a n^ kh o ng^ th a m^
ศรียงค์	s ii j o ng^
ศรียานนท์	s ii j aa n o n^
ศรียานเก็ม	s ii j aa k e m^
ศรียาภัย	s ii j aa ph a j^
ศรีระวงศ์	s ii r a w o ng^
ศรีรังสรรค์	s ii r a ng^ s a n^
ศรีรัตนา	s ii r a t^ t a n aa
ศรีรุ่งเรือง	s ii r u ng^ r vva ng^
ศรีฤกษ์	s ii r qq k^
ศรีละคร	s ii l a kh @@ n^
ศรีละเลิง	s ii l a l qq ng^
ศรีลาภ	s ii l aa p^
ศรีลำดวน	s ii l a m^ d uua n^
ศรีวรขาน	s ii w @@ n^ kh aa n^
ศรีวรพงษ์พันธ์	s ii w @@ r a ph o ng^ ph a n^
ศรีวรรณ	s ii w a n^
ศรีวรรณา	s ii w a n^ n aa
ศรีวสุภิรมย์	s ii w a s u ph i r o m^
ศรีวัชรเมธากุล	s ii w a t^ ch a r a m ee th aa k u n^
ศรีวัฒนประภา	s ii w a t^ th a n a pr a ph aa
ศรีวานิชภูมิ	s ii w aa n i t^ ch a ph uu m^
ศรีวารี	s ii w aa r ii
ศรีวิกรม์	s ii w i k @@ n^
ศรีวิจิตร	s ii w i c i t^
ศรีวิชัย	s ii w i ch a j^
ศรีวิไล	s ii w i l a j^
ศรีวุฒิชาญ	s ii w u t^ th i ch aa n^
ศรีสถิตย์	s ii s a th i t^
ศรีสมวงศ์	s ii s o m^ w o ng^
ศรีสมุทรนาค	s ii s a m u t^ n aa k^
ศรีสวัสดิ์	s ii s a w a t^
ศรีสวาสดิ์	s ii s a w aa t^
ศรีสอ้าน	s ii s a z aa n^
ศรีสังข์	s ii s a ng^
ศรีสังคม	s ii s a ng^ kh o m^
ศรีสันติสุข	s ii s a n^ t i s u k^
ศรีสาทร	s ii s aa th @@ n^
ศรีสารคาม	s ii s aa r a kh aa m^
ศรีสุข	s ii s u k^
ศรีสุทธิยากร	s ii s u t^ th i j aa k @@ n^
ศรีสุภา	s ii s u ph aa
ศรีสุรพล	s ii s u r a ph o n^
ศรีสุราช	s ii s u r aa t^
ศรีสุรินทร์	s ii s u r i n^
ศรีสุวรรณ	s ii s u w a n^
ศรีสุโร	s ii s u r oo
ศรีหล้า	s ii l aa
ศรีอนุรักษ์	s ii z a n u r a k^
ศรีอมรศักดิ์	s ii z a m @@ n^ s a k^
ศรีอรัญญ์	s ii z a r a n^ j a
ศรีอรุณ	s ii z a r u n^
ศรีอาชวนนท์	s ii z aa ch uua n o n^
ศรีอารวงศา	s ii z aa n^ w o ng^ s aa
ศรีอีสาน	s ii z ii s aa n^
ศรีอุทธวงศ์	s ii z u t^ th a w o ng^
ศรีอุบล	s ii z u b o n^
ศรีอ่อน	s ii z @@ n^
ศรีเกิด	s ii k qq t^
ศรีเนียน	s ii n iia n^
ศรีเพ็ญ	s ii ph e n^
ศรีเฟื่องฟุ้ง	s ii f vva ng^ f u ng^
ศรีเมือง	s ii m vva ng^
ศรีเสวก	s ii s a w ee k^
ศรีแกล้ว	s ii kl xx w^
ศรีแก้ว	s ii k xx w^
ศรีแตงอ่อน	s ii t xx ng^ z @@ n^
ศรีแปงวงค์	s ii p xx ng^ w o ng^
ศรีแสงนาม	s ii s xx ng^ n aa m^
ศรีโพธิ์ทอง	s ii ph oo th @@ ng^
ศรีโมรา	s ii m oo r aa
ศรีโลพันธุ์	s ii l oo ph a n^
ศรีโสธร	s ii s oo th @@ n^
ศรีใส	s ii s a j^
ศรีไทยคอนโด	s ii th a j^ kh @@ n^ d oo
ศรีไพรวรรณ	s ii phr a j^ w a n^
ศรุติพงศ์โภคิน	s a r u t^ ph o ng^ ph oo kh i n^
ศรุติสุต	s a r u t^ s u t^
ศรแดง	s @@ n^ d xx ng^
ศรไขว้	s @@ n^ khw a j^
ศวิตชาติ	s a w i t^ t a ch aa t^
ศศิจุลกะ	s a s i c u n^ l a k a
ศศิธร	s a s i th @@ n^
ศศิประภา	s a s i pr a ph aa
ศศิประภายิม	s a s i pr a ph aa j i m^
ศักดาทร	s a k^ d aa th @@ n^
ศักดาพิศิษฏ์	s a k^ d aa ph i s i t^
ศักดาภิพาณิชย์	s a k^ d aa ph i ph aa n i t^
ศักดิกุล	s a k^ d i k u n^
ศักดิษฐานนท์	s a k^ d i t^ th aa n o n^
ศักดิเศรษฐ์	s a k^ d i s ee t^
ศักดิ์กรีรินทร์	s a k^ kr ii r i n^
ศักดิ์จารุพร	s a k^ c aa r u ph @@ n^
ศักดิ์ประชา	s a k^ pr a ch aa
ศักดิ์วีระกุล	s a k^ w ii r a k u n^
ศักดิ์ศิริ	s a k^ s i r i
ศักดิ์สิทธิ์	s a k^ s i t^
ศักดิ์เพชร	s a k^ ph ee t^
ศักดิ์เมืองแกลง	s a k^ m vva ng^ kl oo ng^
ศักดิ์เสมอชัย	s a k^ s a m qq ch a j^
ศักดิ์โยธิน	s a k^ j oo th i n^
ศักดิ์ไทย	s a k^ th a j^
ศันสนียกุลวิไล	s a n^ s a n ii j a k u n^ w i l a j^
ศัลยพงษ์	s a n^ l a j a ph o ng^
ศาสนเที่ยง	s aa s o n^ th iia ng^
ศิยานนท์	s i j aa n o n^
ศิรกรวิไล	s i r a k @@ n^ w i l a j^
ศิรนานนท์	s i r a n aa n o n^
ศิรวัชรินทร์	s i r a w a t^ ch a r i n^
ศิระฉายา	s i r a ch aa j aa
ศิระเลิศ	s i r a l qq t^
ศิริกุล	s i r i k u n^
ศิริขันธ์	s i r i kh a n^
ศิริจรรยา	s i r i c a n^ j aa
ศิริจันทโรภาส	s i r i c a n^ th a r oo ph aa t^
ศิริชัย	s i r i ch a j^
ศิริชุมแสง	s i r i ch u m^ s xx ng^
ศิริทองโสภา	s i r i th @@ ng^ s oo ph aa
ศิรินวกุล	s i r i n a w a k u n^
ศิรินาวิน	s i r i n aa w i n^
ศิรินิล	s i r i n i n^
ศิรินุพงศ์	s i r i n u ph o ng^
ศิริบรรเทิง	s i r i b a n^ th qq ng^
ศิริบริรักษ์	s i r i b @@ r i r a k^
ศิริบันเทิง	s i r i b a n^ th qq ng^
ศิริบุญรอด	s i r i b u n^ r @@ t^
ศิริบูรณ์	s i r i b uu n^
ศิริปุญโญทัย	s i r i p u j oo th a j^
ศิริผลา	s i r i ph a l aa
ศิริพงษ์	s i r i ph o ng^
ศิริพงษ์ปรีดา	s i r i ph o ng^ pr ii d aa
ศิริพันธุ์	s i r i ph a n^
ศิริพานิช	s i r i ph aa n i t^
ศิริพานิชย์	s i r i ph aa n i t^
ศิริพูล	s i r i ph uu n^
ศิริภิญญานนท์	s i r i ph i n^ j aa n o n^
ศิริภูล	s i r i ph uu n^
ศิริมงคลนาวิน	s i r i m o ng^ kh o n^ l a n aa w i n^
ศิริมงคลสกุล	s i r i m o ng^ kh o n^ l a s a k u n^
ศิริมาตย์	s i r i m aa t^
ศิริมานนท์	s i r i m aa n o n^
ศิริรัตน์อัสดร	s i r i r a t^ z a t^ s a d @@ n^
ศิริฤทัยวัฒนา	s i r i r v th a j^ w a t^ th a n aa
ศิริลักษณ์	s i r i l a k^
ศิริลัทธยากร	s i r i l a t^ th a j aa k @@ n^
ศิริลัทพร	s i r i l a t^ ph @@ n^
ศิริวงศ์	s i r i w o ng^
ศิริวรรณ	s i r i w a n^
ศิริวัฒนา	s i r i w a t^ th a n aa
ศิริวัฒน์	s i r i w a t^
ศิริวัติ	s i r i w a t^
ศิริวันสาณฑ์	s i r i w a n^ s aa n^
ศิริวุฒิ	s i r i w u t^
ศิริศรีโร	s i r i s ii r oo
ศิริสรณ์	s i r i s @@ n^
ศิริสังข์	s i r i s a ng^
ศิริสันธนะ	s i r i s a n^ th a n a
ศิริสัมพันธ์	s i r i s a m^ ph a n^
ศิริสานนท์	s i r i s aa n o n^
ศิริสูตร์	s i r i s uu t^
ศิริเจริญ	s i r i c a r qq n^
ศิริเนาวกุล	s i r i n a w^ w a k u n^
ศิริแก้ว	s i r i k xx w^
ศิริโกมุท	s i r i k oo m u t^
ศิริไปล์	s i r i pl
ศิรโยธินภักดี	s i r a j oo th i n^ ph a k^ d ii
ศิลปศร	s i n^ l a p a s @@ n^
ศิลปอาชา	s i n^ l a p a z aa ch aa
ศิลปาจารย์	s i n^ l a p aa c aa n^
ศิลปี	s i n^ l a p ii
ศิลาชัย	s i l aa ch a j^
ศิลาพันธ์	s i l aa ph a n^
ศิลาอ่อน	s i l aa z @@ n^
ศิวรักษ์	s i w a r a k^
ศิวะกุล	s i w a k u n^
ศิวะเกื้อ	s i w a k vva
ศิษย์	s i t^
ศิษย์กันภัย	s i t^ k a n^ ph a j^
ศิษย์ขุน	s i t^ kh u n^
ศิษย์คนองศักดิ์	s i t^ kh a n o ng^ s a k^
ศิษย์ชัชวาลย์	s i t^ ch a t^ ch a w aa n^
ศิษย์ช่างศิลป์	s i t^ ch aa ng^ s i n^
ศิษย์ตราษตระการ	s i t^ tr aa t^ s a tr a k aa n^
ศิษย์ทรายทอง	s i t^ s aa j^ th @@ ng^
ศิษย์นฤพนธ์	s i t^ n a r v ph o n^
ศิษย์นายกอนงค์	s i t^ n aa j o k^ z a n o ng^
ศิษย์บางพระจันทร์	s i t^ b aa ng^ phr a c a n^
ศิษย์ประกายฟ้า	s i t^ pr a k aa j^ f aa
ศิษย์ผล	s i t^ ph o n^
ศิษย์พยัคฆ์	s i t^ ph a j a k^
ศิษย์พระพรหม	s i t^ phr a phr o m^
ศิษย์พ่อดำ	s i t^ ph @@ d a m^
ศิษย์ฟ้าอมร	s i t^ f aa z a m @@ n^
ศิษย์ยอดธง	s i t^ j @@ t^ th o ng^
ศิษย์ศรีคร้าม	s i t^ s ii khr aa m^
ศิษย์สองพี่น้อง	s i t^ s @@ ng^ ph ii n @@ ng^
ศิษย์สีหมอก	s i t^ s ii m @@ k^
ศิษย์หมอเส็ง	s i t^ m @@ s e ng^
ศิษย์หลวงพ่อพูล	s i t^ l uua ng^ ph @@ ph uu n^
ศิษย์หลักเมือง	s i t^ l a k^ m vva ng^
ศิษย์หิรัญ	s i t^ h i r a n^
ศิษย์อำนวย	s i t^ z a m^ n uua j^
ศิษย์เกรียงไกร	s i t^ kr iia ng^ kr a j^
ศิษย์เลิศชัย	s i t^ l qq t^ ch a j^
ศิษย์เสน่ห์	s i t^ s a n ee
ศิษย์เส่ย	s i t^ s
ศิษย์โคดม	s i t^ kh oo d o m^
ศิษย์โบ๊เบ๊	s i t^ b b ee
ศิษย์โสภา	s i t^ s oo ph aa
ศิษย์ไตรภูมิ	s i t^ tr a j^ ph uu m^
ศิษย์ไฝแดง	s i t^ f a j^ d xx ng^
ศุกระฤกษ์	s u k^ a r qq k^
ศุขบุญมาก	s u k^ b u n^ m aa k^
ศุขพิมาย	s u k^ ph i m aa j^
ศุขสวัสดิ	s u k^ s a w a t^ d i
ศุขีวิริยะ	s u k^ ii w i r i j a
ศุภการ	s u p^ ph a k aa n^
ศุภทรัพย์	s u p^ ph a s a p^
ศุภธนพัฒน์	s u p^ ph a th o n^ ph a t^
ศุภพันธุ์ภิญโญ	s u p^ ph a ph a n^ ph i n^ j oo
ศุภมงคล	s u p^ ph a m o ng^ kh o n^
ศุภวงศ์	s u p^ ph a w o ng^
ศุภสมุด	s u p^ ph a s a m u t^
ศุภโชคไพศาล	s u p^ ph a ch oo k^ ph a j^ s aa n^
ศุภไทย	s u p^ ph a th a j^
ศูนย์กีฬาน้อยใน	s uu n^ k ii l aa n @@ j^ n a j^
สกาวเดือน	s a k aa w^ d vva n^
สกิดใจ	s a k i t^ c a j^
สกุลทรัพย์ไพศาล	s a k u n^ s a p^ ph a j^ s aa n^
สกุลเจริญสุข	s a k u n^ c a r qq n^ s u k^
สกุลเลิศผาสุข	l qq t^ ph aa s u k^
สก๊อต	s a k @@ t^
สงค์ธนาพิทักษ์	s o ng^ th a n aa ph i th a k^
สงฆ์ประชา	s o ng^ pr a ch aa
สงวนความดี	s a ng uua n^ khw aa m^ d ii
สงวนชาติศรไกร	s a ng uua n^ ch aa t^ s @@ n^ kr a j^
สงวนพงศ์	s a ng uua n^ ph o ng^
สงวนวงศ์ชัย	s a ng uua n^ w o ng^ ch a j^
สงวนศักดิ์ภักดี	s a ng uua n^ s a k^ ph a k^ d ii
สงวนสมบัติ	s a ng uua n^ s o m^ b a t^
สงสมพันธุ์	s o ng^ s o m^ ph a n^
สง่าพล	s a ng aa ph o n^
สติเบิร์ท	s a t i b qq t^
สถาปิตานนท์	s a th aa p i t aa n o n^
สถาพร	s a th aa ph @@ n^
สถาอานันท์	s a th aa z aa n a n^
สถิรกุล	s a th i r a k u n^
สถิรชวาล	s a th i r a ch a w aa n^
สถิรบุตร	s a th i r a b u t^
สธนพงศ์	s @@ th a n a ph o ng^
สนธิ	s o n^ th i
สนธิขันธ์	s o n^ th i kh a n^
สนธิจิรวงศ์	s o n^ th i c i r a w o ng^
สนธิไชย	s o n^ th i ch a j^
สนวนรัมย์	s a n uua n^ r a m^
สนิกวาที	s a n i k^ k a w aa th ii
สนิทกลาง	s a n i t^ kl aa ng^
สนิทวงศ์	s a n i t^ w o ng^
สนิทวงศ์ชัย	s a n i t^ w o ng^ ch a j^
สนิทวงศ์เสนี	s a n i t^ w o ng^ s ee n ii
สนแจ้ง	s o n^ c xx ng^
สปริงเก็ตต์	s a pr i ng^ k e t^
สภานุชาติ	s a ph aa n u ch aa t^
สภาวสุ	s a ph aa w a s u
สมคะเน	s o m^ kh a n ee
สมคิด	s o m^ kh i t^
สมชัย	s o m^ ch a j^
สมณะ	s a m a n a
สมทรัพย์	s o m^ s a p^
สมทัศน์	s o m^ th a t^
สมบัติพิบูลย์	s o m^ b a t^ ph i b uu n^
สมบัติศิริ	s o m^ b a t^ s i r i
สมบัติเจริญ	s o m^ b a t^ c a r qq n^
สมบุญธรรม	s o m^ b u n^ th a m^
สมบูรณ์	s o m^ b uu n^
สมบูรณ์ทรัพย์	s o m^ b uu n^ s a p^
สมพงษ์	s o m^ ph o ng^
สมพิทักษ์	s o m^ ph i th a k^
สมพิมพ์	s o m^ ph i m^
สมมาตร	s o m^ m aa t^
สมยาประเสริฐ	s o m^ m a j aa pr a s qq t^
สมรรถวิทยาเวช	s a m a t^ th a w i t^ th a j aa w ee t^
สมวงศ์	s o m^ w o ng^
สมศรี	s o m^ s ii
สมะลาภา	s a m a l aa ph aa
สมัครราษฎร์	s a m a k^ r aa t^
สมัครสมาน	s a m a k^ s a m aa n^
สมานจิต	s a m aa n^ c i t^
สมานฉันท์	s a m aa n^ ch a n^
สมานตระกูลชัย	s a m aa n a tr a k uu n^ ch a j^
สมาหาร	s a m aa h aa n^
สมุทรนาวี	s a m u t^ n aa w ii
สมุทรสาคร	s a m u t^ s aa kh @@ n^
สมุทรักษ์	s a m u th a r a k^
สมุทรานนท์	s a m u t^ aa n o n^
สมุทรโคจร	s a m u t^ kh oo c @@ n^
สมุทวณิช	s a m u th a w a n i t^
สมเด็จพระสังฆราช	s o m^ d e t^ phr a s a ng^ kh a r aa t^
สมใจ	s o m^ c a j^
สยามวาลา	s a j aa m^ w aa l aa
สรงกระสินธ์	s o ng^ kr a s i n^
สรรพศรี	s a p^ ph a s ii
สรสุชาติ	s @@ r a s u ch aa t^
สระทองเวียน	s a th @@ ng^ w iia n^
สระบัว	s a b uua
สระโพธิกุล	s a ph oo th i k u n^
สรเทศน์	s @@ r a th ee t^
สร่างทุกข์	s aa ng^ th u k^
สร้อยเสนา	s @ j^ s ee n aa
สร้างไธสง	s aa ng^ th a j^ s o ng^
สลักเพชร	s a l a k^ ph ee t^
สลักใจ	s a l a k^ c a j^
สวนดอกไม้	s uua n^ d @@ k^ m aa j^
สวนศรี	s a w a n a s ii
สวนสิริ	s uua n^ s i r i
สวนสุวรรณ	s uua n^ s u w a n^
สวนานนท์	s a w a n aa n o n^
สวนแก้ว	s uua n^ k xx w^
สวยสด	s uua j^ s o t^
สวอเรซ	s @@ w qq r ee s^
สวัสดิผล	s a w a t^ d i ph o n^
สวัสดิวัตน์	s a w a t^ d i w a t^
สวัสดิ์พาณิชย์	s a w a t^ ph aa n i t^
สวัสดิ์รักเกียรติ	s a w a t^ r a k^ k iia t^
สวัสดิ์ศรี	s a w a t^ s ii
สวัสดี	s a w a t^ d ii
สว่างกุล	s a w aa ng^ k u n^
สว่างล้ำ	s a w aa ng^ l a m^
สว่างศรี	s a w aa ng^ s ii
สว่างแจ้ง	s a w aa ng^ c xx ng^
สหชัยรุ่งเรือง	s a h a ch a j^ r u ng^ r vva ng^
สหนาวิน	s a h a n aa w i n^
สหวงษ์	s a h a w o ng^
สหัชธนชัย	s a h a t^ th a n a ch a j^
สองเมือง	s @@ ng^ m vva ng^
สอนบุตรนาค	s @@ n^ b u t^ n aa k^
สอนระเบียบ	s @@ n^ r a b iia p^
สอนวิเชียร	s @@ n^ w i ch iia n^
สอนศิริ	s @@ n^ s i r i
สอนสะอาด	s @@ n^ s a z aa t^
สอนไสย์	s @@ n^ s a j^
สอเหลบ	s @@ l o p^
สะมะอุน	s a m a z u n^
สะสมทรัพย์	s a s o m^ s a p^
สะเดิด	s a d qq t^
สะเทิงรัมย์	s a th qq ng^ r a m^
สะเทิ้นรัมย์	s a th qq n^ r a m^
สังขดุลย์	s a ng^ kh a d u n^
สังขทรัพย์	s a ng^ kh a s a p^
สังขะทรัพย์	s a ng^ kh a s a p^
สังข์ประไพ	s a ng^ pr a ph a j^
สังข์พุ่ม	s a ng^ ph u m^
สังข์สระน้อย	s a ng^ s a n @@ j^
สังข์เงิน	s a ng^ ng qq n^
สังข์โต	s a ng^ t oo
สังคปรีชา	s a ng^ kh a pr ii ch aa
สังวริบุตร	s a ng^ w @@ r i b u t^
สังวโร	s a ng^ w a r oo
สังสะโอภาส	s a ng^ s a z oo ph aa t^
สัจจกุล	s a t^ c a k u n^
สัจจชลพันธ์	s a t^ c ch o n^ ph a n^
สัจจวาณิชย์	s a t^ c a w aa n i t^
สัจจะสารสิน	s a t^ c a s aa r a s i n^
สัจจานนท์	s a t^ c aa n o n^
สัจจานิตย์	s a t^ c aa n i t^
สัจจิพานนท์	s a t^ c i ph aa n o n^
สัจจเดว	s a t^ c a d ee w^
สัจยากร	s a t^ c a j aa k @@ n^
สัญญา	s a n^ j aa
สัตตบงกช	s a t^ t a b o ng^ k o t^
สัตบุษ	s a t^ b u t^
สัตยธรรม	s a t^ t a j a th a m^
สัตยวงษ์	s a t^ t a j a w o ng^
สัตยา	s a t^ t a j aa
สัตยานุรักษ์	s a t^ t a j aa n u r a k^
สัตย์ศักดิ์สิทธิ์	s a t^ s a k^ s i t^
สันกาลาคีรี	s a n^ k aa l aa kh ii r ii
สันตินธรกุล	s a n^ t i n^ th @@ r a k u n^
สันติประภพ	s a n^ t i pr a ph o p^
สันติวัฒนา	s a n^ t i w a t^ th a n aa
สันติสุขนิรันดร์	s a n^ t i s u k^ n i r a n^
สันติเทวกุล	s a n^ t i th ee w^ w a k u n^
สันติเมทนีดล	s a n^ t i m ee th a n ii d o n^
สันธนะพานิช	s a n^ th a n a ph aa n i t^
สัพโส	s a p^ ph a s oo
สัมบุณณานนท์	s a m^ b u n^ n aa n o n^
สัมปหังสิต	s a m^ p a h a ng^ s i t^
สาขากร	s aa kh aa k @@ n^
สาคร	s aa kh @@ n^
สาครจันทร์	s aa kh @@ n^ c a n^
สาครพิทักษ์	s aa kh @@ n^ ph i th a k^
สาครสิน	s aa kh @@ n^ s i n^
สาคริก	s aa khr i k^
สาตรพันธุ์	s aa t^ ph a n^
สามชัยวิเศษสุก	s aa m^ ch a j^ w i s ee t^ s u k^
สามช่า	s aa m^ ch aa
สามิภักดิ์	s aa m i ph a k^
สายควัน	s aa j^ khw a n^
สายชล	s aa j^ ch o n^
สายนุ้ย	s aa j^ n u j^
สายประดิษฐ์	s aa j^ pr a d i t^
สายประสาท	s aa j^ pr a s aa t^
สายปัญญา	s aa j^ p a n^ j aa
สายสนั่น	s aa j^ s a n a n^
สายสอน	s aa j^ s @@ n^
สายสุพรรณ	s aa j^ s u ph a n^
สายเชื้อ	s aa j^ ch vva
สายเทพ	s aa j^ th ee p^
สายแวว	s aa j^ w xx w^
สายโยธา	s aa j^ j oo th aa
สารคาม	s aa r a kh aa m^
สารชาติ	s aa r a ch aa t^
สารทศิลป์ศุภา	s aa r a th a s i n^ s u ph aa
สารนอก	s aa n^ n @@ k^
สารพัดนึก	s aa r a ph a t^ n v k^
สารสิน	s aa r a s i n^
สาระผล	s aa r a ph o n^
สาราคำ	s aa r aa kh a m^
สารีพิมพ์	s aa r ii ph i m^
สารีฟ	s aa r ii f^
สาลิวรรธนะ	s aa l i w a t^ th a n a
สาลีรัฐวิภาค	s aa l ii r a t^ th a w i ph aa k^
สาวนายน	s aa w a n aa j o n^
สาวันดี	s aa w a n^ d ii
สาสกุล	s aa s a k u n^
สาเมาะ	s aa m @
สาและ	s aa l x
สาโรวาท	s aa r oo w aa t^
สำเภาดี	s a m^ ph a w^ d ii
สำเร	s a m^ r ee
สำเร็จ	s a m^ r e t^
สำเร็จวาณิชย์	s a m^ r e t^ w aa n i t^
สิงคะเนติ	s i ng^ kh a n ee t i
สิงสง	s i ng^ s o ng^
สิงหพัลลภ	s i ng^ h a ph a n^ l o p^
สิงหลกะ	s i ng^ h o n^ k a
สิงหวนวัฒน์	s i ng^ h a w a n a w a t^
สิงหอำพล	s i ng^ h a z a m^ ph o n^
สิงหะ	s i ng^ h a
สิงหา	s i ng^ h aa
สิงหาปัด	s i ng^ h aa p a t^
สิงหเนตร	s i ng^ h a n ee t^
สิงห์กรุงธน	s i ng^ kr u ng^ th o n^
สิงห์ขรณ์	s i ng^ kh @@ n^
สิงห์ชัชวาลย์	s i ng^ ch a t^ ch a w aa n^
สิงห์ดงไทย	s i ng^ d o ng^ th a j^
สิงห์ทอง	s i ng^ th @@ ng^
สิงห์มนัสศักดิ์	s i ng^ m a n a t^ s a k^
สิงห์มุ้ย	s i ng^ m u j^
สิงห์ยอดฟ้า	s i ng^ j @@ t^ f aa
สิงห์ยะบุศย์	s i ng^ j a b u t^
สิงห์ลำพอง	s i ng^ l a m^ ph @@ ng^
สิงห์วังชา	s i ng^ w a ng^ ch aa
สิงห์สมัย	s i ng^ s a m a j^
สิงห์สุวรรณ	s i ng^ s u w a n^
สิงห์เสน่ห์	s i ng^ s a n ee
สิงห์โตทอง	s i ng^ t oo th @@ ng^
สิงห์ไพร	s i ng^ phr a j^
สิทธิจิรวัฒนกุล	s i t^ th i c i r a w a t^ th a n a k u n^
สิทธิธรรม	s i t^ th i th a m^
สิทธิบุญเลิศ	s i t^ th i b u n^ l qq t^
สิทธิประศาสน์	s i t^ th i pr a s aa t^
สิทธิประเสริฐ	s i t^ th i pr a s qq t^
สิทธิพรม	s i t^ th i phr o m^
สิทธิพันธุ์	s i t^ th i ph a n^
สิทธิรักษ์	s i t^ th i r a k^
สิทธิวรนันท์	s i t^ th i w @@ r a n a n^
สิทธิวัจน์	s i t^ th i w a t^
สิทธิศาสตร์	s i t^ th i s aa t^
สิทธิสมวงศ์	s i t^ th i s o m^ w o ng^
สิทธิสุนทร	s i t^ th i s u n^ th @@ n^
สิทธิเขตต์	s i t^ th i kh ee t^
สิทธิเวช	s i t^ th i w ee t^
สิทธิแพทย์	s i t^ th i ph xx t^
สิทธิไชย	s i t^ th i ch a j^
สิทธิไตรย์	s i t^ th i tr a j^
สิทธีอมร	s i t^ th ii z a m @@ n^
สินคณาวิวัฒน์	s i n^ kh a n aa w i w a t^
สินทวี	s i n^ th a w ii
สินธวณรงค์	s i n^ th a w ee n a r o ng^
สินธวานนท์	s i n^ th a w aa n o n^
สินธุปัน	s i n^ th u p a n^
สินธุรักษ์	s i n^ th u r a k^
สินธุเดชะ	s i n^ th u d ee ch a
สินธุไพร	s i n^ th u phr a j^
สินประยูร	s i n^ pr a j uu n^
สินประสาธน์	s i n^ pr a s aa t^
สินรัชตานันท์	s i n^ r a t^ ch a t aa n a n^
สินวัฒนา	s i n^ w a t^ th a n aa
สินสุวงศ์	s i n^ s u w o ng^
สิปปภาค	s i p^ p a ph aa k^
สิมะเสถียร	s i m a s a th iia n^
สิมะโรจน์	s i m a r oo t^
สิรภัทรศักดิ์เมธา	s i r a ph a t^ s a k^ m ee th aa
สิรินุกุล	s i r i n u k u n^
สิริปุณฺโณ	s i r i p u n^ oo
สิริพงษ์	s i r i ph o ng^
สิริพิพัฒน์	s i r i ph i ph a t^
สิริยะเสถียร	s i r i j a s a th iia n^
สิริริน	s i r i r i n^
สิริวัฒนภักดี	s i r i w a t^ th a n a ph a k^ d ii
สิริวัฒนาพรรณวดี	s i r i w a t^ th a n aa ph a n^ w a d ii
สิริวัฒน์ธนกุล	s i r i w a t^ th a n a k u n^
สิริสิงห	s i r i s i ng^ h a
สิริสุขะ	s i r i s u kh a
สิริสุทธิ์	s i r i s u t^
สิริเวชชะพันธ์	s i r i w ee t^ ch a ph a n^
สิริโยธิน	s i r i j oo th i n^
สิโรดม	s i r oo d o m^
สิโรรส	s i r oo r o t^
สิ่วไธสง	s i w^ th a j^ s o ng^
สีดา	s ii d aa
สีตบุตร	s ii t a b u t^
สีนะวัฒน์	s ii n a w a t^
สีน้ำ	s ii n aa m^
สีบุญเรือง	s ii b u n^ r vva ng^
สีฟ้า	s ii f aa
สีลาวงษ์	s ii l aa w o ng^
สีวะรา	s ii w a r aa
สีหลักษณ์	s ii l a k^
สีหะวงษ์	s ii h a w o ng^
สีหา	s ii h aa
สีเงิน	s ii ng q n^
สีเสริม	s ii s qq m^
สีแก้ว	s ii k xx w^
สีใส	s ii s a j^
สืบวงศ์ลี	s vv p^ w o ng^ l ii
สืบสายพรหม	s vv p^ s aa j^ phr o m^
สืบสุวรรณ	s vv p^ s u w a n^
สืบแสง	s vv p^ s xx ng^
สื่อสันติสุข	s vv s a n^ t i s u k^
สุขกุลวรเศรษฐ์	s u k^ k u n^ w @@ r a s ee t^
สุขขาวดี	s u k^ kh aa w a d ii
สุขจิตธรรมกุล	s u k^ c i t^ t a th a m^ m a k u n^
สุขจินดาทอง	s u k^ c i n^ d aa th @@ ng^
สุขชุม	s u k^ ch u m^
สุขดำรงค์	s u k^ d a m^ r o ng^
สุขถิ่นไทย	s u k^ th i n^ th a j^
สุขทรามร	s u k^ s aa m @@ n^
สุขธนะ	s u k^ th a n a
สุขน้อย	s u k^ n @@ j^
สุขบุญสังข์	s u k^ kh a b u n^ s a ng^
สุขประกอบ	s u k^ pr a k @@ p^
สุขประสงค์ดี	s u k^ pr a s o ng^ d ii
สุขประสาท	s u k^ pr a s aa t^
สุขพัฒน์	s u k^ ph a t^
สุขพันธ์	s u k^ ph a n^
สุขมาก	s u k^ kh a m aa k^
สุขมากอนันต์	s u k^ kh a m aa k^ z a n a n^
สุขล้อม	s u k^ kh a l @@ m^
สุขวงศ์	s u k^ kh a w o ng^
สุขวัฒนศิริ	s u k^ kh a w a t^ th a n a s i r i
สุขวัฒนาศัย	s u k^ kh a w a t^ th a n aa s a j^
สุขวัฒน์	s u k^ kh a w a t^
สุขศรีวงศ์	s u k^ s ii w o ng^
สุขศาลา	s u k^ s aa l aa
สุขสด	s u k^ s o t^
สุขสถิตย์	s u k^ s a th i t^
สุขสมกิจ	s u k^ s o m^ k i t^
สุขสมปอง	s u k^ s o m^ p @@ ng^
สุขสมเลิศ	s u k^ s o m^ l qq t^
สุขสวัสดิ์	s u k^ s a w a t^
สุขสันต์	s u k^ s a n^
สุขหน้าไม้	s u k^ n aa m aa j^
สุขอุดม	s u k^ kh a z u d o m^
สุขะ	s u kh a
สุขะพิสิษฐ์	s u k^ a ph i s i t^
สุขัคคานนท์	s u kh a k^ kh aa n o n^
สุขารมณ์	s u kh aa r o m^
สุขุมาลจันทร์	s u kh u m aa n^ c a n^
สุขเจริญ	s u k^ c a r qq n^
สุขเสน	s u k^ s ee n^
สุขแก้ว	s u k^ k xx w^
สุขโกกี	s u k^ k oo k ii
สุขโต	s u k^ t oo
สุขโสภา	s u k^ s oo ph aa
สุขใบเย็น	s u k^ b a j^ j e n^
สุขไชย	s u k^ ch a j^
สุขได้พึ่ง	s u k^ d aa j^ ph v ng^
สุคนธปฏิภาค	s u kh o n^ th a p a t i ph aa k^
สุคนธา	s u kh o n^ th aa
สุคันธพันธุ์	s u kh a n^ th a ph a n^
สุจริต	s u c a r i t^
สุจริตกุล	s u c a r i t^ k u n^
สุจริตฉันท์	s u c a r i t^ t a ch a n^
สุจารี	s u c aa r ii
สุจิณฺโณ	s u c i n^ oo
สุชาตวุฒิ	s u ch aa t^ w u t^
สุชาวดี	s u ch aa w a d ii
สุชิยะ	s u ch i j a
สุดกล้า	s u t^ kl aa
สุดลาภา	s u t^ l aa ph aa
สุดสวิงริงโก้	s u t^ s a w i ng^ r i ng^ k oo
สุตสุนทร	s u t a s u n^ th @@ n^
สุตา	s u t aa
สุทธิกมล	s u t^ th i k a m o n^
สุทธิจันทร์	s u t^ th i c a n^
สุทธิชานนท์	s u t^ th i ch aa n o n^
สุทธิธรรม	s u t^ th i th a m^
สุทธิพันธุ์	s u t^ th i ph a n^
สุทธิพิทักษ์	s u t^ th i ph i th a k^
สุทธิวงศ์	s u t^ th i w o ng^
สุทธิวณิชย์	s u t^ th i w a n i t^
สุทธิสงคราม	s u t^ th i s o ng^ khr aa m^
สุทธิสา	s u t^ th i s aa
สุทธิสาคร	s u t^ th i s aa kh @@ n^
สุทธิเดชานัย	s u t^ th i d ee ch aa n a j^
สุทธิโสตถิ์	s u t^ th i s oo t^ th i
สุทัศนะจินดา	s u th a t^ a c i n^ d aa
สุธรรมจรัส	s u th a m^ c a r a t^
สุธรรมพงษ์	s u th a m^ m a ph o ng^
สุธากุล	s u th aa k u n^
สุธานันต์	s u th aa n a n^
สุธีธร	s u th ii th @@ n^
สุนทร	s u n^ th @@ n^
สุนทรนนท์	s u n^ th @@ n^ n o n^
สุนทรผดุงสิน	s u n^ th @@ n^ ph a d u ng^ s i n^
สุนทรพจน์	s u n^ th @@ n^ r a ph o t^
สุนทรพนาเวช	s u n^ th @@ n^ ph a n aa w ee t^
สุนทรพนาเวศ	s u n^ th @@ n^ ph a n aa w ee t^
สุนทรพิธ	s u n^ th a r a ph i t^
สุนทรวร	s u n^ th @@ n^ r a w @@ n^
สุนทรวัฒน์	s u n^ th @@ n^ w a t^
สุนทรวิเนตร์	s u n^ th @@ n^ w i n ee t^
สุนทรศรี	s u n^ th @@ n^ s ii
สุนทรศิริ	s u n^ th @@ n^ s i r i
สุนทรศิลป์ชัย	s u n^ th @@ n^ s i n^ ch a j^
สุนทรสนาน	s u n^ th @@ n^ r a t^ s a n aa n^
สุนทรสีมะ	s u n^ th a r a s ii m a
สุนทรางกูร	s u n^ th a r aa ng^ k uu n^
สุนทรเวช	s u n^ th @@ r a w ee t^
สุบุญ	s u b u n^
สุปริยศิลป์	s u pr i j a s i n^
สุปรีย์	s u pr ii
สุปรีย์ลีลา	s u pr ii l ii l aa
สุพรรณฝ่าย	s u ph a n^ f aa j^
สุพะมูล	s u ph a m uu n^
สุพัฒนกุล	s u ph a t^ th a n a k u n^
สุภจิรกุล	s u p^ ph a c i r a k u n^
สุภสร	s u ph @@ s @@ n^
สุภัควณิช	s u ph a k^ w a n i t^
สุภาพร	s u ph aa ph @@ n^
สุภาพันธ์	s u ph aa ph a n^
สุภาพไพบูลย์	s u ph aa p^ ph a j^ b uu n^
สุภารัตน์	s u ph aa r a t^
สุภาศรี	s u ph aa s ii
สุภาแพ่ง	s u ph aa ph x ng^
สุมนนัฎ	s u m o n^ n a t^
สุมนวรางกูร	s u m o n^ w a r aa ng^ k uu n^
สุมาลยศักดิ์	s u m aa n^ j a s a k^
สุรนิวงศ์	s u r a n i w o ng^
สุรพงษ์ชัย	s u r a ph o ng^ ch a j^
สุรพล	s u r a ph o n^
สุรฤทธิกุล	s u r a r i t^ th i k u n^
สุรวรรณ	s u r a w a n^
สุระจรัส	s u r a c a r a t^
สุระบาล	s u r a b aa n^
สุระเสียง	s u r a s iia ng^
สุรัสวดี	s u r a t^ s a w a d ii
สุรินทร์คำ	s u r i n^ kh a m^
สุริยกุล	s u r i j a k u n^
สุริยง	s u r i j o ng^
สุริยวงศ์	s u r i j a w o ng^
สุริยสัตย์	s u r i j a s a t^
สุริยา	s u r i j aa
สุริยุทธ	s u r i j u t^
สุรเจริญ	s u r a c a r qq n^
สุลาวัลย์	s u l aa w a n^
สุลีสถิร	s u l ii s a th i r a
สุวภาพ	s u w a ph aa p^
สุวรประทีป	s u w @@ r a pr a th ii p^
สุวรรณ	s u w a n^
สุวรรณกิจบริหาร	s u w a n^ n a k i t^ b @@ r i h aa n^
สุวรรณกุล	s u w a n^ n a k u n^
สุวรรณคีรี	s u w a n^ n a kh ii r ii
สุวรรณฉวี	s u w a n^ ch a w ii
สุวรรณทัต	s u w a n^ n a th a t^
สุวรรณบาง	s u w a n^ b aa ng^
สุวรรณประทีป	s u w a n^ n a pr a th ii p^
สุวรรณปัฏนะ	s u w a n^ p a t^ t a n a
สุวรรณปิยะศิริ	s u w a n^ p i j a s i r i
สุวรรณภักดี	s u w a n^ n a ph a k^ d ii
สุวรรณภานนท์	s u w a n^ n a ph aa n o n^
สุวรรณภูมิ	s u w a n^ n a ph uu m^
สุวรรณมงคล	s u w a n^ n a m o ng^ kh o n^
สุวรรณมาศ	s u w a n^ n a m aa t^
สุวรรณรัฐ	s u w a n^ n a r a t^
สุวรรณรัตน์	s u w a n^ n a r a t^
สุวรรณวัฒกี	s u w a n^ n a w a t^ th a k ii
สุวรรณวิจิตร	s u w a n^ w i c i t^
สุวรรณศักดิ์	s u w a n^ n a s a k^
สุวรรณศักดิ์ศรี	s u w a n^ n a s a k^ s ii
สุวรรณศาสน์	s u w a n^ n a s aa t^
สุวรรณศุข	s u w a n^ s u k^
สุวรรณศุภพนา	s u w a n^ s u p^ ph a ph a n aa
สุวรรณสวัสดิ์	s u w a n^ s a w a t^
สุวรรณสุจริต	s u w a n^ s u t^ c a r i t^
สุวรรณอัตถ์	s u w a n^ n a z a t^
สุวรรณานนท์	s u w a n^ n aa n o n^
สุวรรณเมธานนท์	s u w a n^ n a m ee th aa n o n^
สุวรรณเลิศ	s u w a n^ n a l qq t^
สุวรรณเวลา	s u w a n^ n a w ee l aa
สุวรรณแว่นทอง	s u w a n^ w x n^ th @@ ng^
สุวรรณโณ	s u w a n^ n oo
สุวะดี	s u w a d ii
สุวัณณะปุระ	s u w a n^ n a p u r a
สุวัตถิ	s u w a t^ th i
สุวารี	s u w aa r ii
สุวิชากรพงศ์	s u w i ch aa k @@ n^ r a ph o ng^
สุวิทย์	s u w i t^
สุวิพร	s u w i ph @@ n^
สุศรี	s u s ii
สุสังกร์กาญจน์	s u s a ng^ k aa n^
สุสุทธิ	s u s u t^ th i
สุโกศล	s u k oo s o n^
สุโขทัย	s u kh oo th a j^
สุไลมาน	s u l a j^ m aa n^
สุ่นศิริ	s u n^ s i r i
สุ่มประดิษฐ	s u m^ pr a d i t^
สูงกิจบูลย์	s uu ng^ k i t^ b uu n^
สูตะบุตร	s uu t a b u t^
สเกร	s a k ee n^
สแตนลีย์	s a t xx n^ l ii
สโลบล	s a l oo b o n^
สไตลส์	s a t aa
ส่งเสริม	s o ng^ s qq m^
ส่งเสริมสวัสดิ์	s o ng^ s qq m^ s a w a t^
ส่งแสงเติม	s o ng^ s xx ng^ t qq m^
ส่งไพศาล	s o ng^ ph a j^ s aa n^
ส่วนเสน่ห์	s uua n^ s a n ee
ส่องแสง	s @@ ng^ s xx ng^
หงษ์ทอง	h o ng^ th @@ ng^
หงษ์มานพ	h o ng^ m aa n o p^
หงษ์สา	h o ng^ s aa
หงษ์หิรัญ	h o ng^ h i r a n^
หงสกุล	h o ng^ s a k u n^
หงส์ลดารมภ์	h o ng^ l a d aa r o m^
หงุ่ยตระกูล	ng u j^ tr a k uu n^
หญ้าผา	j aa ph aa
หทัยกาญจน์	h a th a j^ k aa n^
หทัยรัตนกุล	h a th a j^ r a t^ t a n a k u n^
หนองกี่พาหุยุทธ	n @@ ng^ k ii ph aa h u j u t^
หนองหินห่าว	n @@ ng^ h i n^ h aa w^
หนานโฮ๊ะ	n aa n a j^ h a
หนุนภักดี	n u n^ ph a k^ d ii
หนุ่มยีนส์ตะวันนา	n u m^ j ii n^ t a w a n^ n aa
หนูขาว	n uu kh aa w^
หนูด้วง	n uu d uua ng^
หนูพรหม	n uu phr o m^
หนูสลุง	n uu s a l u ng^
หนูเทพ	n uu th ee p^
หมวดรันสารคาม	m uua t^ r a n^ s aa r a kh aa m^
หมัดยะลาน	m a t^ j a l aa n^
หมัดศิริ	m a t^ s i r i
หมัดหลำ	m a t^ l a m^
หมั่นอุตส่าห์	m a n^ z u t^ s aa
หมายเจริญ	m aa j^ c a r qq n^
หมื่นสวัสดิ์	m vv n^ s a w a t^
หยุ่น	j u n^
หย่อง	j @@ ng^
หย่างไพบูลย์	j aa ng^ ph a j^ b uu n^
หรรษาวงศ์	h a n^ s aa w o ng^
หริพิทักษ์	r i ph i th a k^
หรุ่มเรืองวงศ์	r u m^ r vva ng^ w o ng^
หรเวชกุล	r a w ee t^ ch a k u n^
หลงจิ	l o ng^ c i
หลวงแนม	l uua ng^ n xx m^
หละโสะ	l a s o
หลังปูเต๊ะ	l a ng^ p uu t e
หลาวเพ็ชร์	l aa w^ ph e t^
หลีกภัย	l ii k^ ph a j^
หลีเหร็ม	l ii r x m^
หล่วงทองหลาง	l uua ng^ th @@ ng^ l aa ng^
หล่อเสถียรธารี	l @@ s a th iia n^ th aa r ii
หวงมณีรุ่งโรจน์	h uua ng^ m a n ii r u ng^ r oo t^
หวลประไพ	h uua n^ pr a ph a j^
หวัง	w a ng^
หวังซื่อกุล	w a ng^ s vv k u n^
หวังเจริญ	w a ng^ c a r qq n^
หวังในธรรม	w a ng^ n a j^ th a m^
หวังไมตรี	w a ng^ m a j^ tr ii
หวานชื่น	w aa n^ ch vv n^
หว่อง	w @ ng^
หว่างหวังศรี	w aa ng^ w a ng^ s ii
หอมกลิ่น	h @@ m^ kl i n^
หอมขจร	h @@ m^ kh a c @@ n^
หอมชิต	h @@ m^ ch i t^
หอยมุกข์	h @ j^ m u k^
หอรุ่งเรือง	h @@ r u ng^ r vva ng^
หอวัง	h @@ w a ng^
หะยีฮาซัน	h a j ii h aa s a n^
หัตถสงเคราะห์	h a t^ th a s o ng^ khr @
หัวใจศิลป์	h uua c a j^ s i n^
หัสดิน	h a t^ s a d i n^
หัสดีวิจิตร	h a t^ s a d ii w i c i t^
หาญคำภา	h aa n^ kh a m^ ph aa
หาญจริง	h aa n^ c i ng^
หาญทะเล	h aa n^ th a l ee
หาญบุญทรง	h aa n^ b u n^ s o ng^
หาญประดิษฐ์	h aa n^ pr a d i t^
หาญปราบ	h aa n^ pr aa p^
หาญวุฒินานนท์	h aa w u t^ th i n aa n o n^
หาญสวัสดิ์	h aa n^ s a w a t^
หาญสุจินต์	h aa n^ s u c i n^
หาญเทศ	h aa n^ th ee t^
หาญโยธิน	h aa n^ j oo th i n^
หาญไฟฟ้า	h aa n^ f a j^ f aa
หาบุญพาด	h aa b u n^ ph aa t^
หารคำตัน	h aa n^ kh a m^ t a n^
หินเธาว์	h i n^ th a w^
หิมพานต์	h i m^ m a ph aa n^
หิมรัตน์	h i m^ m a r a t^
หิมะทองคำ	h i m a th @@ ng^ kh a m^
หิมาลัยยิม	h i m aa l a j^ j i m^
หิรัญญ์ธนภูวดล	h i r a n^ th a n a ph uu w a d o n^
หิรัญทรัพย์	h i r a n^ s a p^
หิรัญพฤกษ์	h i r a n^ phr v k^
หิรัญยัษฐิติ	h i r a n^ j a t^ s a th i t i
หิรัญวงษ์กุล	h i r a n^ j a w o ng^ k u n^
หิรัญศรี	h i r a n^ s ii
หิรัญโชติ	h i r a n^ j a ch oo t^
หีบทอง	h ii p^ th @@ ng^
หุตะวัฒนะ	h u t a w a t^ th a n a
หุตะสิงห์	h u t a s i ng^
หุตาคม	h u t aa kh o m^
หุราพันธ์	h u r aa ph a n^
หุวะนันทน์	h u w a n a n^
หุ่นทองคำ	h u n^ th @@ ng^ kh a m^
หุ่นน้อย	h u n^ n @@ j^
ห่วงทรัพย์	h uua ng^ s a p^
ห่อนาค	h @@ n aa k^
ห้วยเพชร	h uua j^ ph ee t^
ห้วยไร่	h uua j^ r a j^
ห้าพลัง	h aa ph a l a ng^
ห้าวหาญ	h aa w^ h aa n^
ห้าวเจริญ	h aa w^ c a r qq n^
ฬาพานิช	l aa ph aa n i t^
องค์การณ์	z o ng^ k aa n^
องค์ชัยวัฒนะ	z o ng^ ch a j^ w a t^ th a n a
องค์ชัยศักดิ์	z o ng^ ch a j^ s a k^
อจลธมฺโม	z a c o n^ th a m m oo
อดิเรกสาร	z a d i r ee k^ s aa n^
อดุลกิตติพร	z a d u n^ k i t^ t i ph @@ n^
อดุลยเดชวิกรม	z a d u n^ j a d ee t^ w i kr o m^
อดุลสุทธิกุล	z a d u n^ s u t^ th i k u n^
อดุลเดชจรัส	z a d u n^ d ee t^ c a r a t^
อติภทฺโท	z a t i ph o t^ th oo
อติโพธิ	z a t i ph oo
อธิษฐาน	z a th i t^ th aa n^
อนรรฆพันธ์	z a n a k^ ph a n^
อนวัชกชกร	z o n^ w a t^ k o t^ ch a k @@ n^
อนันตกุล	z a n a n^ t a k u n^
อนันตกูล	z a n a n^ t a k uu n^
อนันตณรงค์	z a n a n^ t a n a r o ng^
อนันตยะ	z a n a n^ t a j a
อนันตสาคร	z a n a n^ t a s aa kh @@ n^
อนันตเมฆ	z a n a n^ t a m ee k^
อนันต์	z a n a n^
อนามพงษ์	z a n aa m a ph o ng^
อนาลโย	z a n aa l a j oo
อนิรุทธเทวา	z a n i r u th a th ee w aa
อนุกฤตยาวรรณ	z a n u kr i t^ t a j aa w a n^
อนุชิตชาญชัย	z a n u ch i t^ ch aa n^ ch a j^
อนุตระกูลชัย	z a n u tr a k uu n^ ch a j^
อนุพงษ์ภิชาติ	z a n u ph o ng^ ph i ch aa t^
อนุมานราชธน	z a n u m aa n^ r aa t^ ch a th o n^
อนุวรรณ	z a n u w a n^
อนุศิลป์	z a n u s i n^
อนุอินทร์	z a n u z i n^
อภัยวงศ์	z a ph a j^ w o ng^
อภิชนาธง	z a ph i ch a n aa th o ng^
อภิชัย	z a ph i ch a j^
อภิชาตวรศิลป์	z a ph i ch aa t^ t a w @@ r a s i n^
อภิญญากุล	z a ph i n^ j aa k u n^
อภิญญาพงศ์	z a ph i n^ j aa ph o ng^
อภิญญาวาท	z a ph i n^ j aa w aa t^
อภิบาลศรี	z a ph i b aa n^ s ii
อภิรักษ์ธนากร	z a ph i r a k^ th a n aa k @@ n^
อภิรัตนพันธุ์	z a ph i r a t^ t a n a ph a n^
อภิสมัยมงคล	z a ph i t^ s a m a j^ m o ng^ kh o n^
อมตยา	z a m^ m a t a j aa
อมตวณิชย์	z a m^ m a t a w a n i t^
อมรกุลดิลก	z a m @@ n^ k u n^ d i l o k^
อมรฉัตร	z a m @@ n^ ch a t^
อมรชัยฤกษ์	z a m @@ n^ ch a j^ r qq k^
อมรบุณยกร	z a m @@ n^ b u n^ j a k @@ n^
อมรวิวัฒน์	z a m @@ n^ w i w a t^
อมรศักดิ์ชัย	z a m @@ n^ s a k^ ch a j^
อมรศุภศิริ	z a m @@ s u p^ s i r i
อมรเลิศศักดิ์	z a m @@ n^ l qq t^ s a k^
อมาตยกุล	z a m aa t^ t a j a k u n^
อมิตรพ่าย	z a m i t^ ph aa j^
อยู่ดี	j uu d ii
อยู่บำรุง	j uu b a m^ r u ng^
อยู่ประเสริฐ	j uu pr a s qq t^
อยู่ผาสุข	j uu ph aa s u k^
อยู่พร้อม	j uu phr @@ m^
อยู่ยอด	j uu j @@ t^
อยู่วิทยา	j uu w i t^ th a j aa
อยู่สถาพร	j uu s a th aa ph @@ n^
อยู่เย็น	j uu j e n^
อรดี	z @@ r a d ii
อรทัย	z @@ r a th a j^
อรมุต	z @@ n^ m u t^
อรรคราช	z a k^ kh a r aa t^
อรรณนพพร	z a n^ n a n o p^ ph @@ n^
อรรถกรศิริโพธิ์	z a t^ th a k @@ n^ s i r i ph oo
อรรถชัยมวยไทยยิม	z a t^ th a ch a j^ m uua j^ th a j^ j i m^
อรรถชิตสถาพร	z a t^ th a ch i t^ s a th aa ph @@ n^
อรรถปรียางกูร	z a t^ th a pr ii j aa ng^ k uu n^
อรอุมา	z @@ n^ z u m aa
อรัญนารถ	z a r a n^ j a n aa t^
อริยะชัยพาณิชย์	z a r i j a ch a j^ ph aa n i t^
อริยะมงคล	z a r i j a m o ng^ kh o n^
อริยะวัฒนา	z a r i j a w a t^ th a n aa
อรุณ	z a r u n^
อรุณฉาน	z a r u n^ ch aa n^
อรุณพิพัฒน์	z a r u n^ ph i ph a t^
อรุณรังษี	z a r u n^ r a ng^ s ii
อรุณรุ่งไพศาล	z a r u n^ r u ng^ ph a j^ s aa n^
อรุณวงษ์	z a r u n^ w o ng^
อรุณวัฒนกูล	z a r u n^ w a t^ th a n a k uu n^
อรุณินท์	z a r u n i n^
อรุณเกษร	z a r u n^ k ee s @@ n^
อรุณเวสสะเศรษฐ	z a r u n^ w ee t^ s a s ee t^
อรุณเหลือง	z a r u n^ l vva ng^
อรุณโรจน์ปัญญา	z a r u n^ n a r oo t^ p a n^ j aa
อวยชัย	z uua j^ ch a j^
อวิหิงสานนท์	z a w i h i ng^ s aa n o n^
อสุรินทร์	z a s u r i n^
ออมสินนพกุล	z @@ m^ s i n^ n o p^ ph a k u n^
ออมไธสง	z @@ m^ th a j^ s o ng^
อะคาซาน	z a kh aa s aa n^
อะสีติรัตน์	z a s ii t i r a t^
อะสุชีวะ	z a s u ch ii w a
อักขระชาตะ	z a k^ kh a r a ch aa t a
อักขี	z a k^ kh ii
อักษรชื่น	z a k^ s @@ n^ ch vv n^
อักษรณรงค์	z a k^ s @@ r a n a r o ng^
อักษรนันทน์	z a k^ s @@ n^ n a n^
อัคคะทวีวัฒน์	z a k^ kh a th a w ii w a t^
อัครนิธิเมธรัฐ	z a k^ khr a n i th i m ee th a r a t^
อัคราช	z a k^ kh a r aa t^
อัครเศรณี	z a k^ kh a r a s ee r a n ii
อังกินันทน์	z a ng^ k i n a n^
อังคุณชัย	z a ng^ kh u n^ n a ch a j^
อังค์สุธาสาวิทย์	z a ng^ s u th aa s aa w i t^
อังศวานนท์	z a ng^ s a w aa n o n^
อังศุโชติ	z a ng^ s u ch oo t^
อังสกุลอาภรณ์	z a ng^ s a k u n^ z aa ph @@ n^
อังสนานนท์	z a ng^ s a n aa n o n^
อัจฉริยะฉาย	z a t^ ch a r i j a ch aa j^
อัชชวัฒนา	z a t^ ch a w a t^ th a n aa
อัชฌาศัย	z a t^ ch aa s a j^
อัญชลี	z a n^ ch a l ii
อัญชันบุตร	z a n^ ch a n^ b u t^
อัญชุลีประดิษฐ์	z a n^ ch u l ii pr a d i t^
อัตตกิจกุล	z a t^ t a k i t^ k u n^
อัตตะนันทน์	z a t^ t a n a n^
อัตถากร	z a t^ th aa k @@ n^
อัตถาวงศ์	z a t^ th aa w o ng^
อัถโถปกรณ์	z a t^ th oo p a k @@ n^
อัทธเสรี	z a t^ th a s ee r ii
อัธยาตมวิทยา	z a t^ th a j aa t o m^ w i t^ th a j aa
อันติมานนท์	z a n^ t i m aa n o n^
อันทะคำภู	z a n^ th a kh a m^ ph uu
อันทะไชย	z a n^ th a ch a j^
อันวา	z a n^ w aa
อับดุลบุตร	z a p^ d u n^ l a b u t^
อัฟโฟลเทอร์	z a f^ f oo l^ th qq
อัมพรพงษ์	z a m^ ph @@ n^ ph o ng^
อัมพรพิสิฏฐ์	z a m^ ph @@ n^ ph i s i t^
อัมพรมหา	z a m^ m a phr o m^ h aa
อัมพุช	z a m^ ph u t^
อัมระนันทน์	z a m^ m a r a n a n^
อัลบอน	z a l^ b @@ n^
อัลฟอร์ด	z a n^ f @@ t^
อัลภาชน์	z a n^ ph aa
อัลเทอร์เมท	z a n^ th qq m ee t^
อัศวกุล	z a t^ s a w a k u n^
อัศวธีรากุล	z a t^ s a w a th ii r aa k u n^
อัศวนนท์	z a t^ s a w a n o n^
อัศวนภากาศ	z a t^ s a w a n a ph aa k aa t^
อัศวลาภสกุล	z a t^ s a w a l aa ph a s a k u n^
อัศววิไล	z a t^ s a w a w i l a j^
อัศวินวิจิตร	z a t^ s a w i n^ w i c i t^
อัศวเหม	z a t^ s a w a h ee m^
อัศว์ศิวะกุล	z a t^ s i w a k u n^
อัสสรัตนกุล	z a t^ s a r a t^ t a n a k u n^
อั๋นประเสริฐ	z a n^ pr a s qq t^
อากรสกุล	z aa k @@ n^ r a s a k u n^
อากากูร่า	z aa k aa k uu r aa
อากีล่าร์	z aa k ii l aa
อาขุบุตร	z aa kh u b u t^
อาจวงษ์	z aa t^ w o ng^
อาจวิไล	z aa t^ w i l a j^
อาจาโร	z aa c aa r oo
อาดี	z aa d ii
อานนท์	z aa n o n^
อานิต้า	z aa n i t aa
อาพรสุทธินันธ์	z aa ph @@ n^ s u t^ th i n a n^
อาภรณ์รัตน์	z aa ph @@ n^ r a t^
อาภรณ์สุวรรณ	z aa ph @@ n^ s u w a n^
อาภากร	z aa ph aa k @@ n^
อาภากาศ	z aa ph aa k aa t^
อาภาภิรม	z aa ph aa ph i r o m^
อามระดิษ	z aa m a r a d i t^
อามะตันตรี	z aa m a t a n^ tr ii
อายนบุตร	z aa j a n a b u t^
อารมณ์สวะ	z aa r o m^ s a w a
อารมย์สุข	z aa r o m^ s u k^
อารยวุฒิ	z aa r a j a w u t^
อารยะสกุล	z aa r a j a s a k u n^
อารยางกูร	z aa r a j aa ng^ k uu n^
อาระยานิมิตสกุล	z aa r a j aa n i m i t^ s a k u n^
อารัมภีร	z aa r a m^ ph ii
อารามบอย	z aa r aa m^ b @@ j^
อารียา	z aa r ii j aa
อารีย์กุล	z aa r ii k u n^
อารีย์รัก	z aa r ii r a k^
อารีรอบ	z aa r ii r @@ p^
อารีราชการัณย์	z aa r ii r aa t^ ch a k aa r a n^
อารีเอื้อ	z aa r ii z vva
อาร์	z aa
อาร์สยาม	z aa s a j aa m^
อาวะนิค	z aa w a n i k^
อาษายุทธ	z aa t^ s aa j u t^
อาสนจินดา	z aa t^ s a n a c i n^ d aa
อาสาชนะ	z aa s aa ch a n a
อาสาฬห์ประกิต	z aa s aa n^ pr a k i t^
อาหะหมัด	z aa h a m a t^
อำนวยพร	z a m^ n uua j^ ph @@ n^
อำพัน	z a m^ ph a n^
อำพันวงศ์	z a m^ ph a n^ w o ng^
อำพันสุวรรณ	z a m^ ph a n^ s u w a n^
อำมฤตโชติ	z a m^ m a r i t^ ch oo t^
อำมะรัตน์	z a m^ m a r a t^
อำมาตยกุล	z a m^ m aa t^ t a j a k u n^
อำไพพงษ์	z a m^ ph a j^ ph o ng^
อำไพพิทักษ์วงศ์	z a m^ ph a j^ ph i th a k^ w o ng^
อิงลิช	z i ng^ l i t^
อิชยาวณิชย์	z i t^ ch a j aa w a n i t^
อิชิเกะ	z i ch i k e
อิทธิพลพาณิชย์	z i t^ th i ph o n^ ph aa n i t^
อิทธิสุขนันท์	z i t^ th i s u k^ kh a n a n^
อิทธิอนุชิต	z i t^ th i z a n u ch i t^
อินฉัตร	z i n^ ch a t^
อินต๊ะมี	z i n^ t a m ii
อินทจักร	z i n^ th a c a k^
อินทชัย	z i n^ th a ch a j^
อินทนนท์	z i n^ th a n o n^
อินทนี	z i n^ th a n ii
อินทรกำแหง	z i n^ th a r a k a m^ h xx ng^
อินทรคูสิน	z i n^ th a r a kh uu s i n^
อินทรทัต	z i n^ th a r a th a t^
อินทรบุตร	z i n^ th a r a b u t^
อินทรปาณ	z i n^ th a r a p aa n^
อินทรปาลิต	z i n^ th a r a p aa l i t^
อินทรพรหม	z i n^ th a r a phr o m^
อินทรวัตร	z i n^ th a r a w a t^
อินทรวิจิตร	z i n^ th a r a w i c i t^
อินทรวิทยนันท์	z i n^ th a r a w i t^ th a j a n a n^
อินทรศิลป์	z i n^ th a r a s i n^
อินทรสมบัติ	z i n^ th a r a s o m^ b a t^
อินทรสูต	z i n^ th a r a s uu t^
อินทราวุธ	z i n^ th a r aa w u t^
อินทรเทพ	z i n^ th a r a th ee p^
อินทรโกมาลย์สุต	z i n^ th a r a k oo m aa n^ s u t^
อินทร์จันทร์	z i n^ c a n^
อินทร์ตลาดชุม	z i n^ t a l aa t^ ch u m^
อินทร์รอด	z i n^ r @@ t^
อินทร์ใจเอื้อ	z i n^ c a j^ z vva
อินทร์ไธสง	z i n^ th a j^ s o ng^
อินทฤทธิ์	z i n^ th a r i t^
อินทวงศ์	z i n^ th a w o ng^
อินทสร	z i n^ th a s @@ n^
อินทสโร	z i n^ th a s a r oo
อินทะชัย	z i n^ th a ch a j^
อินทะพงษ์	z i n^ th a ph o ng^
อินทุสมิต	z i n^ th u s a m i t^
อินทเสน	z i n^ th a s ee n^
อินทโชโต	z i n^ th a ch oo t oo
อินนา	z i n^ n aa
อินนุ้ย	z i n^ n u j^
อินพรวิจิตร	z i n^ ph @@ n^ w i c i t^
อินพินิจ	z i n^ ph i n i t^
อินยิน	z i n^ j i n^
อินสว่าง	z i n^ s a w aa ng^
อินสีลอย	z i n^ s ii l @@ j^
อินฺทสุวณฺโณ	z i n^ t^ s u w a n oo
อินแกรมยิม	z i n^ kr xx m^ j i m^
อินแก้ว	z i n^ k xx w^
อินแสง	z i n^ s xx ng^
อิมราพร	z i m^ r aa ph @@ n^
อิศรภักดี	z i s @@ n^ ph a k^ d ii
อิศรางกูร	z i t^ s a r aa ng^ k uu n^
อิศรเสนา	z i t^ s a r a s ee n aa
อิสมาโลน	z i s^ m aa l oo n^
อิสรชัย	z i t^ s a r a ch a j^
อิสระเสนารักษ์	z i t^ s a r a s ee n aa r a k^
อิสรัมย์	z i t^ s a r a m^
อิสรา	z i t^ s a r aa
อิสราชีวิน	z i t^ s a r aa ch ii w i n^
อิสริยะเนตร	z i t^ s a r i j a n ee t^
อิสรไกรศีล	z i t^ s a r a kr a j^ s ii n^
อิสสระ	z i t^ s a r a
อิสโร	z i t^ s a r oo
อิ่มจรรยา	z i m^ c a n^ j aa
อิ่มทรัพย์	z i m^ s a p^
อิ่มเอิบปฐม	z i m^ z qq p^ p a th o m^
อีทีโอ	z ii th ii z oo
อีลิทยิม	z ii l i t^ j i m^
อีแต	z ii t xx
อึ้งตระกูล	z v ng^ tr a k uu n^
อึ้งทรงธรรม	z v ng^ s o ng^ th a m^
อึ้งรังษี	z v ng^ r a ng^ s ii
อึ้งอัมพรวิไล	z v ng^ z a m^ ph @@ n^ w i l a j^
อึ๊งบำรุงพันธุ์	z v ng^ b a m^ r u ng^ ph a n^
อึ๊งภากรณ์	z v ng^ ph aa k @@ n^
อุชชิน	z u t^ ch i n^
อุณหธูป	z u n^ h a th uu p^
อุดมฉวี	z u d o m^ ch a w ii
อุดมพานิช	z u d o m^ ph aa n i t^
อุดมศักดิ์	z u d o m^ s a k^
อุดมศิลป์	z u d o m^ s i n^
อุดมเดช	z u d o m^ d ee t^
อุดมแก้วกาญจนา	z u d o m^ k xx w^ k aa n^ c a n aa
อุดมโชค	z u d o m^ ch oo k^
อุดมไพจิตรกุล	z u d o m^ ph a j^ c i t^ k u n^
อุดล	z u d o n^
อุตตมะโยธิน	z u t^ t a m a j oo th i n^
อุตรสินธุ์	z u t^ t a r a s i n^
อุตโมท	z u t^ m oo t^
อุทก	z u th o k^
อุทรา	z u t^ s aa
อุทัยรัตน์	z u th a j^ r a t^
อุทัยวรรณ์	z u th a j^ w a n^
อุทัยสาง	z u th a j^ s aa ng^
อุทัยเฉลิม	z u th a j^ ch a l qq m^
อุทัยเวียนกุล	z u th a j^ w iia n^ k u n^
อุบลมณี	z u b o n^ m a n ii
อุระงาม	z u r a ng aa m^
อุรัสยะนันทน์	z u r a t^ s a j a n a n^
อุวรรณโณ	z u w a n^ n oo
อุสมานมูซา	z u s a m aa n^ m uu s aa
อุไรพร	z u r a j^ ph @@ n^
อุไรรัตน์	z u r a j^ r a t^
อุไรศรี	z u r a j^ s ii
อุ่นทรพันธุ์	z u n^ th @@ r a ph a n^
อุ่นสำราญ	z u n^ s a m^ r aa n^
อุ่นหนู	z u n^ n uu
อุ่นอำไพ	z u n^ z a m^ ph a j^
อุ่มมล	z u m^ m o n^
อูนากูล	z uu n aa k uu n^
อู่ตะเภา	z uu t a ph a w^
อแมนด้า	z a m xx n^ d aa
อโศกสิน	z a s oo k^ s i n^
อ่อนฉิม	z @@ n^ ch i m^
อ่อนฉ่ำ	z @@ n^ ch a m^
อ่อนละเอียด	z @@ n^ l a z iia t^
อ่อนวงศ์	z @@ n^ w o ng^
อ่อนวิมล	z @@ n^ w i m o n^
อ่อนเกตุพล	z @@ n^ k ee t u ph o n^
อ่อนเอี่ยม	z @@ n^ z iia m^
อ่อนโม้	z @@ n^ m oo
อ่ำประสิทธิ์	z a m^ pr a s i t^
อ้นรักษ์	z o n^ r a k^
ฮมแสน	s xx n^
ฮอลลีวูด	h @@ l^ l ii w uu t^
ฮอสุวรรณ	h @@ s u w a n^
ฮะซานี	h a s aa n ii
ฮัน	h a n^
ฮันตระกูล	h a n^ tr a k uu n^
ฮันเก้	h a n^ k ee
ฮันเซน	h a n^ s ee n^
ฮานส์สัน	h aa n^ s a n^
ฮิมสกุล	h i m^ s a k u n^
ฮิลเดอบรานด์	h i n^ d qq br aa n^
ฮุนตระกูล	h u n^ tr a k uu n^
เกตะวันดี	k ee t a w a n^ d ii
เกตุคง	k ee t^ kh o ng^
เกตุทอง	k ee t^ th @@ ng^
เกตุทัต	k ee t^ th a t^
เกตุประภากร	k ee t^ pr a ph aa k @@ n^
เกตุวรสุนทร	k ee t^ w @@ r a s u n^ th @@ n^
เกตุวัตถา	k ee t^ w a t^ th aa
เกตุเพ็ชร์	k ee t^ ph e t^
เกตุเรน	k ee t u r ee n^
เกตุแก้ว	k ee t^ k xx w^
เกยุราพันธุ์	k ee j u r aa ph a n^
เกรย์	kr ee
เกรียงไกร	kr iia ng^ kr a j^
เกร้กสัน	kr k^ s a n^
เกลี้ยงจันทร์	kl iia ng^ c a n^
เกศรินทร์	k ee s a r i n^
เกษกมล	k ee t^ k a m o n^
เกษจำรัส	k ee t^ c a m^ r a t^
เกษตรศิริ	k a s ee t^ s i r i
เกษตรสิน	k a s ee t^ s i n^
เกษมทองศรี	k a s ee m^ th @@ ng^ s ii
เกษมมัสสุ	k a s ee m^ m a t^ s u
เกษมศรี	k a s ee m^ s ii
เกษมสันต์	k a s ee m^ s a n^
เกษมสุวรรณ	k a s ee m^ s u w a n^
เกษรศุกร์	k ee s @@ n^ s u k^
เกษอินทร์	k a s ee z i n^
เกษารัตน์	k ee s aa r a t^
เกษโกวิท	k ee s a k oo w i t^
เกสรทอง	k ee s @@ n^ th @@ ng^
เกาะจู	k @ c uu
เกาไศยนันท์	k a w^ s a j a n a n^
เกิดฉาย	k qq t^ ch aa j^
เกิดดี	k qq t^ d ii
เกิดทองทวี	k qq t^ th @@ ng^ th a w ii
เกิดนิมิตร	k qq t^ n i m i t^
เกิดประสพ	k qq t^ pr a s o p^
เกิดปราชญ์	k qq t^ pr aa t^
เกิดผล	k qq t^ ph o n^
เกิดพันธุ์	k qq t^ ph a n^
เกิดพุดซา	k qq t^ ph u t^ s aa
เกิดเจริญ	k qq t^ c a r qq n^
เกิดเทศ	k qq t^ th ee t^
เกิดแก้ว	k qq t^ k xx w^
เกียรติ	k iia t^
เกียรติกรีรินทร์	k iia t^ k a r ii r i n^
เกียรติชูศักดิ์	k iia t^ ch uu s a k^
เกียรติทรงฤทธิ์	k iia t^ s o ng^ r i t^
เกียรติทวีสุข	k iia t^ th a w ii s u k^
เกียรตินิวัฒน์	k iia t^ n i w a t^
เกียรตินุกูล	k iia t^ n u k uu n^
เกียรติบัณฑิต	k iia t^ t i b a n^ d i t^
เกียรติบุญยงค์	k iia t^ t i b u n^ j o ng^
เกียรติบุษบา	k iia t^ t i b u t^ s a b aa
เกียรติบ้านช่อง	k iia t^ b aa n^ ch @ ng^
เกียรติประภัสร์	k iia t^ t i pr a ph a t^
เกียรติประสานชัย	k iia t^ pr a s aa n^ ch a j^
เกียรติพิทักษ์	k iia t^ ph i th a k^
เกียรติพ่วงจินดา	k iia t^ ph uua ng^ c i n^ d aa
เกียรติยงยุทธ	k iia t^ t i j o ng^ j u t^
เกียรติวันชัย	k iia t^ w a n^ ch a j^
เกียรติวันเวย์	k iia t^ w a n^ w ee
เกียรติวายุภักษ์	k iia t^ w aa j u ph a k^
เกียรติวินัยสกุล	k iia t^ w i n a j^ s a k u n^
เกียรติวิเชียร	k iia t^ w i ch iia n^
เกียรติศักดิ์โชคชัย	k iia t^ t i s a k^ ch oo k^ ch a j^
เกียรติสนธยา	k iia t^ t i s o n^ th a j aa
เกียรติสิงห์น้อย	k iia t^ s i ng^ n @@ j^
เกียรติสุรนนท์	k iia t^ s u r a n o n^
เกียรติสุริยา	k iia t^ s u r i j aa
เกียรติสูงเนิน	k iia t^ s uu ng^ n qq n^
เกียรติอดิศักดิ์	k iia t^ t i z a d i s a k^
เกียรติอรดี	k iia t^ r a d ii
เกียรติเกรียงไกร	k iia t^ kr iia ng^ kr a j^
เกียรติเพชร	k iia t^ ph ee t^
เกียรติเมืองยม	k iia t^ m vva ng^ j o m^
เกียรติไชยากร	k iia t^ ch a j^ j aa k @@ n^
เกี่ยวข้อง	k iia w^ kh @ ng^
เกื้อกูลรัฐ	k vva k uu n^ r a t^
เก็บทรัพย์	k e p^ s a p^
เก่งการค้า	k e ng^ k aa n^ kh aa
เก่งการุณ	k e ng^ k aa r u n^
เก้าวิชิต	k a w^ w i ch i t^
เขมปัญโญ	kh ee m^ p a n^ j oo
เขมพิมุก	kh ee m^ ph i m u k^
เขมะจารุ	kh ee m a c aa r u
เขมะโยธิน	kh ee m a j oo th i n^
เขมโก	kh ee m^ k oo
เขียว	kh iia w^
เขียวฤทธิ์	kh iia w^ r i t^
เขียวสมบัติ	kh iia w^ s o m^ b a t^
เขียวแก้ว	kh iia w^ k xx w^
เข็มกลัด	kh e m^ kl a t^
เข็มกำเนิด	kh e m^ k a m^ n qq t^
เข็มมณฑา	kh e m^ m o n^ th aa
เข็มเพชร	kh e m^ ph e t^
เข็มเล็ก	kh e m^ l e k^
เค	kh ee
เคนจันทึก	kh ee n^ a n^ th v k^
เคราซ์	khr a w^
เคราเซอร์	khr a w^ s qq
เคราแก้ว	khr a w^ k xx w^
เครือคงคา	khr vva kh o ng^ kh aa
เครืองาม	khr vva ng aa m^
เครือทิวา	khr vva th i w aa
เครือรัตน์	khr vva r a t^
เครือสุวรรณศิริ	khr vva s u w a n^ n a s i r i
เครืออ่อน	khr vva z @@ n^
เครือเสน	khr vva s ee n^
เครือแก้ว	khr vva k xx w^
เครือแตง	khr vva t xx ng^
เคาวเวลล์	kh aa w^ w ee n^
เคียงศิริ	kh iia ng^ s i r i
เค้ามูลคดี	kh a w^ m uu n^ kh a d ii
เค้าแก้ว	kh a w^ k xx w^
เงากระจ่าง	ng a w^ kr a c aa ng^
เงินชูกลิ่น	ng q n^ ch uu kl i n^
เงินยวง	ng q n^ j uua ng^
เงินศรีสุข	ng q n^ s ii s u k^
เงินหมื่น	ng q n^ m vv n^
เงื่อนตะคุ	ng vva n^ t a kh u
เจทท์	c ee t^
เจนกิจณรงค์	c ee n^ k i t^ c a n a r o ng^
เจนธนากุล	c ee n^ th a n aa k u n^
เจนมานะ	c ee n^ m aa n a
เจนอักษร	c ee n^ z a k^ s @@ n^
เจนอัศวเมธี	c ee n^ z a t^ s a w a m ee th ii
เจนเซน	c ee n^ s ee n^
เจนเซ่น	c ee n^ s e n^
เจมีน่า	c ee m ii n aa
เจริญช่าง	c a r qq n^ ch aa ng^
เจริญธรรม	c a r qq n^ th a m^
เจริญนนทสิทธิ์	c a r qq n^ n o n^ th a s i t^
เจริญประเสริฐ	c a r qq n^ pr a s qq t^
เจริญปุระ	c a r qq n^ p u r a
เจริญผล	c a r qq n^ ph o n^
เจริญภักดี	c a r qq n^ ph a k^ d ii
เจริญยศ	c a r qq n^ j o t^
เจริญรัตนกุล	c a r qq n^ r a t^ t a n a k u n^
เจริญรัตนธารากูล	c a r qq n^ r a t^ t a n a th aa r aa k uu n^
เจริญราช	c a r qq n^ r aa t^
เจริญฤทธิ์	c a r qq n^ r i t^
เจริญลักษณ์	c a r qq n^ j a l a k^
เจริญวงศ์ศักดิ์	c a r qq n^ w o ng^ s a k^
เจริญศรี	c a r qq n^ s ii
เจริญศิริ	c a r qq n^ s i r i
เจริญสุข	c a r qq n^ s u k^
เจริญสุวรรณ	c a r qq n^ s u w a n^
เจริญเชื้อ	c a r qq n^ ch vva
เจริญเมือง	c a r qq n^ m vva ng^
เจริญเศรษฐศิลป์	c a r qq n^ s ee t^ th a s i n^
เจียจิรโชติ	c iia c i r a ch oo t^
เจียมธีรสกุล	c iia m^ th ii r a s a k u n^
เจียมวิจักษณ์	c iia m^ w i c a k^
เจียมศรีพงษ์	c iia m^ s ii ph o ng^
เจียมเจริญ	c iia m^ c a r qq n^
เจียรณัย	c iia r a n a j^
เจียรถาวร	c iia r a th aa w @@ n^
เจียรวนนท์	c iia r uua n o n^
เจียรสถาวงศ์	c iia n^ s a th aa w o ng^
เจียรสุข	c iia n^ s u k^
เจ้าฟัาทีปังกรรัศมีโชติ	c aa w^ f a aa th ii p a ng^ kr r a t^ s a m ii ch oo t^
เจ้าฟ้ากรรณิกาแก้ว	c a w^ f aa k a n^ n i k aa k xx w^
เจ้าฟ้าจักรพงษ์ภูวนาถ	c a w^ f aa c a k^ kr a ph o ng^ ph uu w a n aa t^
เจ้าฟ้าจันทรมณฑล	c a w^ f aa c a n^ th a r a m o n^ th o n^
เจ้าฟ้าจาตุรนต์รัศมี	c a w^ f aa c aa t u r o n^ r a t^ s a m ii
เจ้าฟ้าจิตรเจริญ	c a w^ f aa c i t^ tr a c a r qq n^
เจ้าฟ้าจุฑาธุชธราดิลก	c a w^ f aa c u th aa th u t^ ch a th a r aa d i l o k^
เจ้าฟ้าจุฬาภรณวลัยลักษณ์ฯ	c a w^ f aa c u l aa ph @@ n^ w a l a j^ l a k^
เจ้าฟ้าตรีเพ็ชรุตม์ธำรง	c a w^ f aa tr ii ph e t^ u t^ th a m^ r o ng^
เจ้าฟ้าทองอิน	c a w^ f aa th @@ ng^ z i n^
เจ้าฟ้าบริพัตรสุขุมพันธุ์	c a w^ f aa b @@ r i ph a t^ s u kh u m^ ph a n^
เจ้าฟ้าพัชรกิติยาภา	c a w^ f aa ph a t^ k i t i j aa ph aa
เจ้าฟ้าภาณุรังษีสว่างวงศ์	c a w^ f aa ph aa n u r a ng^ s ii s a w aa ng^ w o ng^
เจ้าฟ้ามหามาลา	c a w^ f aa m a h aa m aa l aa
เจ้าฟ้ามหาวชิรุณหิศ	c a w^ f aa m a h aa w a ch i r u n^ h i t^
เจ้าฟ้ายุคลฑิฆัมพร	c a w^ f aa j u kh o n^ th i kh a m^ ph @@ n^
เจ้าฟ้าวไลยอลงกรณ์	c a w^ f aa w^ l a j^ z a l o ng^ k @@ n^
เจ้าฟ้าศิริราชกกุธภัณฑ์	c a w^ f aa s i r i r aa t^ k a k u t^ th a ph a n^
เจ้าฟ้าสิริวัณณวรี	c a w^ f aa s i r i w a n^ n^ w a r ii
เจ้าฟ้าอัษฎางค์เดชาวุธ	c a w^ f aa z a t^ s a d aa ng^ d ee ch aa w u t^
เจ้าฟ้าเพชรรัตนราชสุดา	c a w^ f aa ph e t^ ch a r a t^ r aa t^ ch a s u d aa
เจ๊ะมัน	c e m a n^
เจ๊ะโมง	c e m oo ng^
เฉยฉิว	ch qq j^ ch i w^
เฉยไธสง	ch qq j^ th a j^ s o ng^
เฉลิมชัยเจริญกิจ	ch a l qq m^ ch a j^ c a r qq n^ k i t^
เฉลิมบูรณะวงศ์	ch a l qq m^ b uu r a n a w o ng^
เฉลิมภูษิตารักษ์	ch a l qq m^ ph uu s i t aa r a k^
เฉลิมแสน	ch a l qq m^ s xx n^
เฉื่อยฉ่ำ	ch vva j^ ch a m^
เฉื่อยมะเริง	ch vva j^ m a r qq ng^
เฉ่งไล่	ch x ng^ l a j^
เชตมี	ch ee t a m ii
เชยอรุณ	ch qq j^ z a r u n^
เชษฐโชติศักดิ์	ch ee t^ th a ch oo t^ s a k^
เชอร์ม็อค	ch qq m @ k^
เชาวนาศัย	ch a w^ w a n aa s a j^
เชาวน์ประยูร	ch a w^ pr a j uu n^
เชาวราษฎร์	ch a w^ w a r aa t^
เชาวลิต	ch a w^ w a l i t^
เชาว์กิตติโสภณ	ch a w^ k i t^ t i s oo ph o n^
เชาว์วิศิษฐ	ch a w^ w i s i t^
เชาว์ศิริกุล	ch a w^ s i r i k u n^
เชาว์สุรินทร์	ch a w^ s u r i n^
เชิญยิ้ม	ch qq n^ j i m^
เชิดชัย	ch qq t^ ch a j^
เชิดชูบุพการี	ch qq t^ ch uu b u p^ ph a k aa r ii
เชิดโฉม	ch qq t^ ch oo m^
เชียงกูล	ch iia ng^ k uu n^
เชียงทา	ch iia ng^ th aa
เชียรสงค์	ch iia n^ s o ng^
เชี่ยวชาญ	ch iia w^ ch aa n^
เชี่ยวน้อย	ch iia w^ n @@ j^
เชี่ยววงศ์กุล	ch iia w^ w o ng^ k u n^
เชี่ยวอร่าม	ch iia w^ z a r aa m^
เชื้อชาติ	ch vva ch aa t^
เชื้อวู้หลิม	ch vva w uu l i m^
เชื้อเมืองพาน	ch vva m vva ng^ ph aa n^
เชื้อไทย	ch vva th a j^
เช็คลีย์	ch e k^ l ii
เซ่งย่อง	s ee ng^ j @ ng^
เซ้งบ๊อกซิ่ง	s ee ng^ b @ k^ s i ng^
เดชกิจวิกรม	d ee t^ k i t^ w i kr o m^
เดชกิจสุนทร	d ee t^ k i t^ s u n^ th @@ n^
เดชกุญชร	d ee t^ k u n^ ch @@ n^
เดชมิตร	d ee t^ m i t^
เดชอุดม	d ee t^ z u d o m^
เดชะปัญญา	d ee ch a p a n^ j aa
เดชะรินทร์	d ee ch a r i n^
เดชาชัย	d ee ch aa ch a j^
เดชแสง	d ee t^ s xx ng^
เดมอน	d ee m @@ n^
เดวา	d ee w aa
เดวิส	d ee w i t^
เดวี่	d ee w ii
เดอะสกา	d q s a k aa
เตจะสา	t ee c a s aa
เตชวรสินสกุล	t ee ch uua n^ s i n^ s a k u n^
เตชวัณโณ	t ee ch w a n^ oo
เตชสิทธิ์	t ee ch a s i t^
เตชะกำพุ	t ee ch a k a m^ ph u
เตชะตานนท์	t ee ch a t aa n o n^
เตชะธนชัยพัฒน์	t ee ch a th a n a ch a j^ ph a t^
เตชะธีราวัฒน์	t ee ch a th ii r aa w a t^
เตชะรักษ์พงศ์	t ee ch a r a k^ ph o ng^
เตชะรัตนประเสริฐ	t ee ch a r a t^ t a n a pr a s qq t^
เตชะวิจิตร์	t ee ch a w i c i t^
เตชะหรูวิจิตร	t ee ch a r uu w i c i t^
เตชะอภัยคุณ	t ee ch a z a ph a j^ j a kh u n^
เตชะเกรียงไกร	t ee ch a kr iia ng^ kr a j^
เตชะไพบูลย์	t ee ch a ph a j^ b uu n^
เตชาชาญ	t ee ch aa ch aa n^
เตมียาเวส	t ee m ii j aa w ee t^
เตมีรักษ์	t ee m ii r a k^
เตริยาภิรมย์	t a r i j aa ph i r o m^
เตาะเจริญสุข	t @ c a r qq n^ s u k^
เติมธนาภรณ์	t qq m^ th a n aa ph @@ n^
เตียตระกูล	t iia tr a k uu n^
เต็นปักษี	t e n^ p a k^ s ii
เต็มชำนาญ	t e m^ ch a m^ n aa n^
เต็มปรีชา	t e m^ pr ii ch aa
เต้พันธ์	t a j^ ph a n^
เถรว่อง	th ee r a w @ ng^
เถิดเทิง	th qq t^ th qq ng^
เถื่อนกลาง	th vva n^ kl aa ng^
เทพกาญจนา	th ee p^ k aa n^ c a n aa
เทพธานี	th ee p^ th aa n ii
เทพนม	th ee ph a n o m^
เทพนา	th ee p^ n aa
เทพนุภา	th ee p^ n u ph aa
เทพบุตร	th ee p^ ph a b u t^
เทพพิทักษ์	th ee p^ ph i th a k^
เทพพิมล	th ee p^ ph i m o n^
เทพมงคล	th ee p^ ph a m o ng^ kh o n^
เทพมณี	th ee p^ m a n ii
เทพยสุวรรณ	th ee p^ ph a j a s u w a n^
เทพสุทิน	th ee p^ s u th i n^
เทพหัสดิน	th ee p^ h a t^ s a d i n^
เทพานนท์	th ee ph aa n o n^
เทพโสธร	th ee p^ ph a s oo th @@ n^
เทพไพฑูรย์	th ee p^ ph a j^ th uu n^
เทภาสิต	th ee ph aa s i t^
เทริโอ	th ee r i z oo
เทวกุล	th ee w^ w a k u n^
เทวานฤมิตรกุล	th ee w aa n a r v m i t^ k u n^
เทวาพิทักษ์ธรรม	th ee w aa ph i th a k^ th a m^
เทศประทีป	th ee t^ s a pr a th ii p^
เทศวิศาล	th ee t^ w i s aa n^
เทศสูงเนิน	th ee t^ s uu ng^ n qq n^
เทิดวงส์	th qq t^ w o ng^
เทียงดาห์	th iia ng^ d aa
เทียนชัยเกิดศิลป์	th iia n^ ch a j^ k qq t^ s i n^
เทียนทอง	th iia n^ th @@ ng^
เทียนสว่าง	th iia n^ s a w aa ng^
เทียนเงิน	th iia n^ ng q n^
เทียนแก้ว	th iia n^ k xx w^
เทียนโพธิ์สุวรรณ์	th iia n^ ph oo s u w a n^
เทียนไพโรจน์	th iia n^ ph a j^ r oo t^
เทียมกำแหง	th iia m^ k a m^ h xx ng^
เทียมชัย	th iia m^ ch a j^
เทียมประเสริฐ	th iia m^ pr a s qq t^
เทียมอัมพร	th iia m^ z a m^ ph @@ n^
เทียมเพ็ชร	th iia m^ ph e t^
เที่ยงธรรม	th iia ng^ th a m^
เทือกสุบรรณ	th vva k^ s u b a n^
เทเลอร์	th ee l qq
เนตรนิยม	n ee t^ n i j o m^
เนตรบุตร	n ee t^ b u t^
เนตรศรีทอง	n ee t^ s ii th @@ ng^
เนตรศิริ	n ee t^ s i r i
เนมิตรมานสุข	n ee m i m aa n^ s u k^
เนรมิตร	n ee r a m i t^
เนาวเกตุ	n a w^ k ee t^
เนียมประดิษฐ์	n iia m^ pr a d i t^
เนียมวัน	n iia m^ w a n^
เนียมไธสง	n iia m^ th a j^ s o ng^
เนื่องจำนงค์	n vva ng^ c a m^ n o ng^
เนื่องภิรมย์	n vva ng^ ph i r o m^
เบญจกุล	b e n^ c a k u n^
เบญจมาศ	b ee n^ c a m aa t^
เบญจฤทธิ์	b e n^ c a r i t^
เบญจลักษณ์	b e n^ c a l a k^
เบญอิบรอฮีม	b ee n^ z i p^ r @@ h ii m^
เบนเนลลี่	b ee n^ n ee n^ l ii
เบลค	bl ee k^
เบอร์ต๊อดตี้	b qq t @@ t^ t ii
เบอร์บริดจ์	b qq br i t^
เบาว์เด้น	b a w^ d ee n^
เบิร์นเนอร์	b qq n^ n qq
เบียดตะคุ	b iia t^ t a kh u
เบี้ยทอง	b iia th @@ ng^
เบื้องบน	b vva ng^ b o n^
เบ็ญจลักษณ์	b e n^ c a l a k^
เปรมธนากุล	pr ee m^ th a n aa k u n^
เปรมปรีดิ์	pr ee m^ pr ii
เปรมภักดิ์	pr ee m^ ph a k^
เปรื่องอักษร	pr vva ng^ z a k^ s @@ n^
เปลี่ยนศรี	pl iia n^ s ii
เปล่งพานิช	pl e ng^ ph aa n i t^
เปล่งศิริวัธน์	pl e ng^ s i r i w a t^
เปสตันยี	p ee s^ t a n^ j ii
เปาอินทร์	p a w^ z i n^
เปาะจิ	p @ c i
เปียกลิ่น	p iia kl i n^
เปี่ยมคุ้ม	p iia m^ kh u m^
เปี่ยมพงศ์สานต์	p iia m^ ph o ng^ s aa n^
เปี่ยมพงษ์สานต์	p iia m^ ph o ng^ s aa n^
เปี่ยมรัตนวงศ์	p iia m^ r a t^ t a n a w o ng^
เปี่ยมสมบูรณ์	p iia m^ s o m^ b uu n^
เปื้องกลาง	p vva ng^ kl aa ng^
เป็งสวัสดิ์	p e ng^ s a w a t^
เป็นต่อ	p e n^ t @@
เผือดผ่อง	ph vva t^ ph @@ ng^
เผ่าจินดา	ph a w^ c i n^ d aa
เผ่าปฏิมากร	ph a w^ p a t i m aa k @@ n^
เฝ้าด่าน	f a w^ d aa n^
เพชรกัณหา	ph e t^ k a n^ h aa
เพชรขุ้ม	ph e t^ kh u m^
เพชรชมภู	ph e t^ ch o m^ ph uu
เพชรดำเนิน	ph e t^ ch a d a m^ n qq n^
เพชรทอง	ph ee t^ th @@ ng^
เพชรประดับ	ph e t^ pr a d a p^
เพชรพนมพร	ph e t^ ph a n o m^ ph @@ n^
เพชรรัตน์	ph e t^ ch a r a t^
เพชรรุ่งเรือง	ph e t^ ch a r u ng^ r vva ng^
เพชรร้อยเอ็ด	ph e t^ r @@ j^ z e t^
เพชรวิเศษศิริ	ph ee t^ w i s ee t^ s i r i
เพชรศรีราชา	ph e t^ ch a s ii r aa ch aa
เพชรสถิตย์	ph e t^ s a th i t^
เพชรสว่าง	ph e t^ s a w aa ng^
เพชรสุพรรณ	ph e t^ s u ph a n^
เพชรเจริญ	ph ee t^ c a r qq n^
เพชรเลิศอนันต์	ph ee t^ l qq t^ z a n a n^
เพชรโรจน์	ph e t^ r oo t^
เพรียบจริยวัฒน์	phr ia p^ c i j a w a t^
เพลินจิต	phl qq n^ c i t^
เพศประเสริฐ	ph ee t^ pr a s qq t^
เพศยนาวิน	ph ee t^ n aa w i n^
เพิ่มฉลาด	ph qq m^ ch a l aa t^
เพิ่มพูนพัชรสุข	ph qq m^ ph uu n^ ph a t^ s u k^
เพิ่มภัทรสกุล	ph qq m^ ph a t^ s a k u n^
เพียงพอ	ph iia ng^ ph @@
เพียงเกษ	ph iia ng^ k ee t^
เพียซ	ph iia s^
เพียยุระ	ph iia j u r a
เพียรชนะ	ph iia n^ ch a n a
เพียรเลิศ	ph iia n^ l qq t^
เพ็งดิษฐ์	ph e ng^ d i t^
เพ็งนรพัฒน์	ph e ng^ n a r a ph a t^
เพ็งบ้านไร่	ph e ng^ b aa n^ r a j^
เพ็งประโคน	ph e ng^ pr a kh oo n^
เพ็งแก้ว	ph e ng^ k xx w^
เพ็ชรพูล	ph e t^ ph uu n^
เพ็ชรอุไร	ph e t^ z u r a j^
เพ็ชรเจริญ	ph e t^ c a r qq n^
เพ็ชร์สุกใส	ph e t^ s u k^ s a j^
เพ็ญกุล	ph e n^ k u n^
เพ็ญชาติ	ph e n^ ch aa t^
เพ็ญแข	ph e n^ kh xx
เฟื่องประกอบ	f vva ng^ pr a k @@ p^
เฟื่องอารมย์	f vva ng^ z aa r o m^
เมกะแดนซ์	m ee k a d xx n^
เมฆมุสิก	m ee k^ m u s i k^
เมฆราตรี	m ee k^ r aa tr ii
เมฆวิเชียร	m ee k^ w i ch iia n^
เมฆสวรรค์	m ee k^ s a w a n^
เมฆอังกูร	m ee k^ z a ng^ k uu n^
เมณฑกา	m ee n^ th a k aa
เมตตาริกานนท์	m ee t^ t aa r i k aa n o n^
เมทะนี	m ee th a n ii
เมธาวรายุทธ	m ee th aa w a r aa j u t^
เมธาวี	m ee th aa w ii
เมธีวิบูลวุฒิ	m ee th ii w i b uu n^ w u t^
เมธีสุวกุล	m ee th ii s u w a k u n^
เมนาคม	m ee n aa kh o m^
เมย์	m ee
เมษะมาน	m ee s a m aa n^
เมษินทรีย์	m ee s i n^ s ii
เมาเร่อ	m a w^ r qq
เมืองขอนแก่น	m vva ng^ kh @@ n^ k x n^
เมืองชัยภูมิ	m vva ng^ ch a j^ j a ph uu m^
เมืองร้อยเอ็ด	m vva ng^ r @@ j^ z e t^
เมืองลพ	m vva ng^ l o p^
เมืองลุง	m vva ng^ l u ng^
เมืองสนธ์	m vva ng^ s o n^
เมืองสิงห์	m vva ng^ s i ng^
เมืองสุข	m vva ng^ s u k^
เมืองสุรินทร์	m vva ng^ s u r i n^
เมืองโคตร	m vva ng^ kh oo t^
เมื่องชุมแพ	m vva ng^ ch u m^ ph xx
เยาดำ	j aa d a m^
เยาวนานนท์	j a w^ w a n aa n o n^
เยาวพลกุล	j a w^ w a ph o n^ k u n^
เยาวสังข์	j a w^ w a s a ng^
เยาะเย้ย	j @ j qq j^
เย็นประเสริฐ	j e n^ pr a s qq t^
เย็นพูนสุข	j e n^ ph uu n^ s u k^
เย็นแข	j e n^ kh xx
เรขานิเทศ	r ee kh aa n i th ee t^
เริงประเสริฐวิทย์	r qq ng^ pr a s qq t^ w i t^
เรียมจินดา	r iia m^ c i n^ d aa
เรี่ยวแรง	r iia w^ r xx ng^
เรืองกาญจนเศรษฐ์	r vva ng^ k aa n^ c a n a s ee t^
เรืองกูล	r vva ng^ k uu n^
เรืองฉาย	r vva ng^ ch aa j^
เรืองนนท์	r vva ng^ n o n^
เรืองฤทธิ์	r vva ng^ r i t^
เรืองวรบูรณ์	r vva ng^ w @@ r a b uu n^
เรืองวิวรรธน์	r vva ng^ w i w a t^
เรืองวุฒิ	r vva ng^ w u t^
เรืองศรี	r vva ng^ s ii
เรืองสุวรรณ	r vva ng^ s u w a n^
เรืองโรจน์	r vva ng^ r oo t^
เรือนนาค	r vva n^ n aa k^
เรือนนินทร์	r vva n^ n i n^
เร่งสมบูรณ์สุข	r ee ng^ s o m^ b uu n^ s u k^
เลขกุล	l ee kh a k u n^
เลขะกุล	l ee k^ a k u n^
เลอร์ช	l qq ch^
เลาวัณย์ศิริ	l a w^ w a n^ s i r i
เลาหกุล	l a w^ h a k u n^
เลาหบุตร	l a w^ h a b u t^
เลาหพงศ์ชนะ	l a w^ h a ph o ng^ ch a n a
เลิศชาญฤทธ์	l qq t^ ch aa n^ r i t^
เลิศชีวกานต์	l qq t^ ch ii w^ w a k aa n^
เลิศชูโชติ	l qq t^ ch uu ch oo t^
เลิศนุวัฒน์	l qq t^ n u w a t^
เลิศประเสริฐ	l qq t^ pr a s qq t^
เลิศปัญญานุช	l qq t^ p a n^ j aa n u t^
เลิศพิชชาพัชร์	l qq t^ ph i t^ ch aa ph a t^
เลิศภควัต	l qq t^ ph a kh a w a t^
เลิศรัตนชัย	l qq t^ r a t^ t a n a ch a j^
เลิศฤทธิ์	l qq t^ r i t^
เลิศวรลักษณ์	l qq t^ w @@ r a l a k^
เลิศวานิชย์กุล	l qq t^ w aa n i t^ k u n^
เลิศสัตยาทร	l qq t^ s a t^ t a j aa th @@ n^
เลิศสุริย์เดช	l qq t^ s u r i d ee t^
เลิศเกษมทรัพย์	l qq t^ k a s ee m^ s a p^
เลิศเกียรติไพบูลย์	l qq t^ k iia t^ t i ph a j^ b uu n^
เลิศไพฑูรย์	l qq t^ ph a j^ th uu n^
เลิศไฟลนก้นบาปชัย	l qq t^ fl oo n^ k o n^ b aa p^ ch a j^
เลียววาริณ	l iia w^ w aa r i n^
เลี่ยนกัตวา	l iia n^ k a t^ t a w aa
เลี่ยมอยู่	l iia m^ j uu
เลี่ยวไพรัตน์	l iia w^ ph a j^ r a t^
เลี้ยงตระกูลงาม	l iia ng^ tr a k uu n^ ng aa m^
เลี้ยงบุญเลิศชัย	l iia ng^ b u n^ l qq t^ ch a j^
เลี้ยงประเสริฐ	l iia ng^ pr a s qq t^
เลี้ยงผ่องพันธุ์	l iia ng^ ph @@ ng^ ph a n^
เลืองวัฒนะวณิช	l vva ng^ w a t^ th a n a w a n i t^
เลือดทหาร	l vva t^ th a h aa n^
เลือดระยอง	l vva t^ r a j @@ ng^
เลื่อมใส	l vva m^ s a j^
เล็กกัมพล	l e k^ k a m^ ph o n^
เล็กจ์	l e k^
เล็กอุทัย	l e k^ z u th a j^
เล่าลือพงศ์ศิริ	l a w^ l vv ph o ng^ s i r i
เล่าเปี่ยม	l a w^ p iia m^
เวชกร	w ee t^ ch a k @@ n^
เวชกามา	w ee t^ ch a k aa m aa
เวชชาชีวะ	w ee t^ ch a ch ii w a
เวชบุล	w ee t^ ch a b u n^
เวชประสิทธิ์	w ee t^ ch a pr a s i t^
เวชภิรมย์	w ee t^ ch a ph i r o m^
เวชวงศา	w ee t^ ch a w o ng^ s aa
เวชสวรรค์	w ee t^ s a w a n^
เวชสิทธิ์	w ee t^ ch a s i t^
เวชสุภาพร	w ee t^ ch a s u ph aa ph @@ n^
เวชานนท์	w ee ch aa n o n^
เวท	w ee t^
เวทยาวงศ์	w ee t^ th a j aa w o ng^
เวทีวุฒาจารย์	w ee th ii w u t^ th aa c aa n^
เวสบุรี	w ee t^ b u r ii
เวียงนนท์	w iia ng^ n o n^
เวียงพิงค์	w iia ng^ ph i ng^
เวียงวิเศษ	w iia ng^ w i s ee t^
เวโรจน์	w ee r oo t^
เศรษฐกร	s ee t^ th a k @@ n^
เศรษฐจินดา	s ee t^ th a c i n^ d aa
เศรษฐธำรงค์	s ee t^ th a th a m^ r o ng^
เศรษฐบุตร	s ee t^ th a b u t^
เศรษฐมานิต	s ee t^ th a m aa n i t^
เศวตพิกุล	s a w ee t^ ph i k u n^
เศวตวิมล	s a w ee t^ w i m o n^
เศวตศิลา	s a w ee t^ s i l aa
เศวตาภรณ์	s a w ee t^ aa ph @@ n^
เศวตาสัย	s a w ee t^ t a w^ s a j^
เศียรสิงห์	s iia n^ s i ng^
เสงี่ยมศักดิ์	s a ng iia m^ s a k^
เสณีตันติกุล	s ee n ii t a n^ t i k u n^
เสถบุตร	s a th a b u t^
เสถียรถิระกุล	s a th iia n^ th i r a k u n^
เสถียรสุต	s a th iia n^ s u t^
เสถียรไทย	s a th iia n^ th a j^
เสนพงศ์	s a n a ph o ng^
เสนะวงศ์	s ee n a w o ng^
เสนาชู	s ee n aa ch uu
เสนาณรงค์	s ee n aa n a r o ng^
เสนานันท์	s ee n aa n a n^
เสนาเมือง	s ee n aa m vva ng^
เสนีย์วงศ์	s ee n ii w o ng^
เสนเนียม	s ee n^ n iia m^
เสปอร์บันด์	s a p @@ b a n^
เสมาเงิน	s ee m aa ng qq n^
เสริงกลาง	s qq ng^ kl aa ng^
เสริมปรุงสุข	s qq m^ pr u ng^ s u k^
เสริมฤทธิรงค์	s qq m^ r i t^ th i r o ng^
เสรีชัย	s ee r ii ch a j^
เสรีธรรมรักษ์	s ee r ii th a m^ m a r a k^
เสรีรักษ์	s ee r ii r a k^
เสรีรังสรรค์	s ee r ii r a ng^ s a n^
เสรีรัตน์	s ee r ii r a t^
เสลานนท์	s ee l aa n o n^
เสวกวิหารี	s a w ee k^ w i h aa r ii
เสวกสูตร	s a w ee k^ s uu t^
เสวตรบุตร	s a w ee t^ b u t^
เสวิกุล	s ee w i k u n^
เสียงทอง	s iia ng^ th @@ ng^
เสียงสมบุญ	s iia ng^ s o m^ b u n^
เสียงหวาน	s iia ng^ w aa n^
เสียมทอง	s iia m^ th @@ ng^
เสียมภักดี	s iia m^ m a ph a k^ d ii
เสือจงพรู	s vva c o ng^ phr uu
เสือทองคำ	s vva th @@ ng^ kh a m^
เสือสกุล	s vva s a k u n^
เสืออินทร์	s vva z i n^
เส็งประเสริฐ	s e ng^ pr a s qq t^
เส็นสมเอียด	s e n^ s o m^ z iia t^
เหตระกูล	h ee tr a k uu n^
เหมพิพัฒน์	h ee m^ ph i ph a t^
เหมมณี	h ee m^ m a n ii
เหมวิบูลย์	h ee m^ m a w i b uu n^
เหมะ	m a
เหมะมูล	h ee m a m uu n^
เหมินทร์	h ee m i n^
เหมือนตา	m vva n^ t aa
เหมือนมาตย์	m vva n^ m aa t^
เหมือนวงษ์	m vva n^ w o ng^
เหมือนศรี	m vva n^ s ii
เหมแดง	h ee m^ d xx ng^
เหรียญทวนทอง	r iia n^ th uua n^ th @@ ng^
เหลาพร	l a w^ ph @@ n^
เหลาแหลม	l a w^ l xx m^
เหลียวรักวงศ์	l iia w^ r a k^ w o ng^
เหลืองทองคำ	l vva ng^ th @@ ng^ kh a m^
เหลืองทองนารา	l vva ng^ th @@ ng^ n aa r aa
เหลืองบริบูรณ์	l vva ng^ b @@ r i b uu n^
เหลืองวิจิตร	l vva ng^ w i c i t^
เหลืองสดใส	l vva ng^ s o t^ s a j^
เหลืองสุนทร	l vva ng^ s u n^ th @@ n^
เหลืองอุทัย	l vva ng^ z u th a j^
เหลืองเพชราภรณ์	l vva ng^ ph ee t^ ch a r aa ph @@ n^
เหล็กแท้	l e k^ th xx
เหล่าธรรมทัศน์	l a w^ th a m^ m a th a t^
เหล่าวัฒนา	l a w^ w a t^ th a n aa
เหล่าวานิช	l a w^ w aa n i t^
เหล่าศิริกุล	l a w^ s i r i k u n^
เหล่าอารยะ	l a w^ z aa r a j a
เหล่าแสงไทย	l a w^ s xx ng^ th a j^
เหิมฮึก	h qq m^ h v k^
เอ	z ee
เอกชัย	z ee k^ k a ch a j^
เอกธวัชกุล	z ee k^ th a w a t^ k u n^
เอกบางไทร	z ee k a b aa ng^ s a j^
เอกพันธ์กุล	z ee k^ k a ph a n^ k u n^
เอกมงคล	z ee k^ k a m o ng^ kh o n^
เอกมงคลไพศาล	z ee k^ k a m o ng^ kh o n^ ph a j^ s aa n^
เอกวัฒนกิจ	z ee k^ w a t^ th a n a k i t^
เอกสมญา	z ee k^ s o m^ j aa
เอกอุรุ	z ee 0k a z u r u
เอกเพชร	z ee k^ ph e t^
เอกแสงกุล	z ee k^ k a s xx ng^ k u n^
เองตระกูล	z ee ng^ tr a k uu n^
เอนกอายุวัฒน์	z a n ee k^ z aa j u w a t^
เอมเมอรี่	z ee m^ m qq r ii
เอมใจ	z ee m^ c a j^
เอสพินเนอร์	z ee t^ ph i n^ n qq
เออเจนี	z qq c ee n ii
เอียดศรีไชย	z iia t^ s ii ch a j^
เอียวศรีวงศ์	z iia w^ s ii w o ng^
เอียสกุล	z iia s a k u n^
เอี่ยมกระสินธุ์	z iia m^ kr a s i n^
เอี่ยมวสันต์	z iia m^ w a s a n^
เอี่ยมวิโรจน์	z iia m^ w i r oo t^
เอี่ยมสะอาด	z iia m^ s a z aa t^
เอี่ยมสุข	z iia m^ s u k^
เอี่ยมสุพรรณ	z iia m^ s u ph a n^
เอี่ยมอ่อง	z iia m^ z @ ng^
เอี่ยมเจริญ	z iia m^ c a r qq n^
เอี่ยมแจ้งพันธุ์	z iia m^ c xx ng^ ph a n^
เอี้ยงสุวรรณปัทมะ	z iia ng^ s u w a n^ p a t^ th a m a
เอื้อกิตติโรจน์	z vva k i t^ t i r oo t^
เอื้อครองธรรม	z vva khr @@ ng^ th a m^
เอื้อถาวรสุข	z vva th aa w @@ n^ s u k^
เอื้อทวีกุล	z vva th a w ii k u n^
เอื้อวิริยานุกูล	z vva w i r i j aa n u k uu n^
เอื้อสังคมเศรษฐ	z vva s a ng^ kh o m^ s ee t^
เอื้อสัมพันธ์	z vva s a m^ ph a n^
เอื้ออภิญญกุล	z vva z a ph i n^ j a k u n^
เอื้ออารียกูล	z vva z aa r ii j a k uu n^
เอื้ออำพน	z vva z a m^ ph o n^
เอื้อเฟื้อ	z vva f vva
เอื้อไพบูลย์	z vva ph a j^ b uu n^
เอเวอร์ริ่งแฮม	z ee w qq r i ng^ h x m^
เอ็กซ์	z e k^
เอ็ม	z e m^
เอ่งฉ้วน	z ee ng^ ch uua n^
เฮมเฮาเซอร์	h ee m^ h aa s qq
แกรนท์	kr xx n^
แกล้วกล้าหาญ	kl xx w^ kl aa h aa n^
แกแล็คซี่	k xx l x k^ s ii
แก่นคูน	k xx n^ kh uu n^
แก่นทอง	k xx n^ th @@ ng^
แก่นนรสิงห์	k x n^ n @@ r a s i ng^
แก่นสิงห์	k xx n^ s i ng^
แก่นเพชร	k xx n^ ph ee t^
แก้วกาญจน์	k xx w^ k aa n^
แก้วกำเนิด	k xx w^ k a m^ n qq t^
แก้วก่า	k xx w^ k a w^
แก้วดวงงาม	k xx w^ d uua ng^ ng aa m^
แก้วทอง	k xx w^ th @@ ng^
แก้วทิตย์	k xx w^ th i t^
แก้วนาม	k xx w^ n aa m^
แก้วนาโพธิ์	k xx w^ n aa ph oo
แก้วน้ำค้าง	k xx w^ n aa m^ kh aa ng^
แก้วบัณฑิต	k xx w^ b a n^ d i t^
แก้วบัวสาย	k xx w^ b uua s aa j^
แก้วประสิทธิ์	k xx w^ pr a s i t^
แก้วผลึก	k xx w^ ph a l v k^
แก้วพรม	k xx w^ phr o m^
แก้วพิจิตร	k xx w^ ph i c i t^
แก้วพิน	k xx w^ ph i n^
แก้วภราดัย	k xx w^ ph a r aa d a j^
แก้วมณี	k xx w^ m a n ii
แก้วมะ	k xx w^ m a
แก้วมะณี	k xx w^ m a n ii
แก้วมีชัย	k xx w^ m ii ch a j^
แก้วละเอียด	k xx w^ l a z iia t^
แก้วสง่า	k xx w^ s a ng aa
แก้วสนิท	k xx w^ s a n i t^
แก้วสว่าง	k xx w^ s a w aa ng^
แก้วสัมฤทธิ์	k xx w^ s a m^ r i t^
แก้วสุขแท้	k xx w^ s u k^ th xx
แก้วสุพรรณ	k xx w^ s u ph a n^
แก้วสุริยะ	k xx w^ s u r i j a
แก้วหลวง	k xx w^ l uua ng^
แก้วหวาน	k xx w^ w aa n^
แก้วเขียว	k xx w^ kh iia w^
แก้วเพิก	k xx w^ ph qq k^
แก้วเรือง	k xx w^ r vva ng^
แก้วเรือน	k xx w^ r vva n^
แก้วแดง	k xx w^ d xx ng^
แก้วไพฑูรย์	k xx w^ ph a j^ th uu n^
แขนควง	kh xx n^ kh uua ng^
แขวัฒนะ	kh a w a t^ th a n a
แข็งขัน	kh x ng^ kh a n^
แคมเปน	kh xx m^ p ee n^
แครี่บอย	kh xx r ii b @@ j^
แคสกี้	kh xx t^ k ii
แจสุรภาพ	c xx s u r a ph aa p^
แจ่มจรัส	c x m^ c a r a t^
แจ่มปฐม	c xx m^ p a th o m^
แจ่มผล	c xx m^ ph o n^
แจ่มศรี	c xx m^ s ii
แจ่มสุวรรณ	c xx m^ s u w a n^
แจ่มเจริญ	c xx m^ c a r qq n^
แจ่มเวหา	c xx m^ w ee h aa
แจ้งมีสุข	c xx ng^ m ii s u k^
แจ้งโพธิ์นาค	c xx ng^ ph oo n aa k^
แชจอหอ	ch xx c @@ h @@
แช่มชื่น	ch x m^ ch vv n^
แช่มรัมย์	ch xx m^ r a m^
แช่มเชื้อ	ch xx m^ ch vva
แซร่าฮ์	s xx r aa
แซ่จัง	s xx c a ng^
แซ่จิ๋ว	s xx c i w^
แซ่จึง	s xx c v ng^
แซ่ตั้ง	s xx t a ng^
แซ่เล้า	s xx l a w^
แซ่เอียะ	s xx z ia
แซ่เฮง	s xx h e ng^
แซ๊ดเลอร์	s xx t^ l qq
แดงจำรูญ	d xx ng^ c a m^ r uu n^
แดงดา	d xx ng^ d aa
แดงบุหงา	d xx ng^ b u ng aa
แดงสี	d xx ng^ s ii
แดงโกเมน	d xx ng^ k oo m ee n^
แดนภูไท	d xx n^ ph uu th a j^
แดนสุพรรณ	d xx n^ s u ph a n^
แตรสังข์	tr xx s a ng^
แตวุง	t xx w u ng^
แต้พานิช	t xx ph aa n i t^
แต้รัตนชัย	t xx r a t^ t a n a ch a j^
แทนกลาง	th xx n^ kl aa ng^
แทนโสภา	th xx n^ s oo ph aa
แท่งทอง	th xx ng^ th @@ ng^
แนวบุญเนียร	n xx w^ b u n^ n iia n^
แน่นหนา	n x n^ n aa
แป้นน้อย	p xx n^ n @@ j^
แป้นพัฒน์	p xx n^ ph a t^
แผ้วพลสง	ph x w^ ph o n^ s o ng^
แฝงสีคำ	f xx ng^ s ii kh a m^
แพทย์รัตน์	ph xx t^ r a t^
แพรสกุล	phr xx s a k u n^
แพร่พันธุ์	phr xx ph a n^
แพร่แสงเอี่ยม	phr xx s xx ng^ z iia m^
แพลงศิลป์	phl xx ng^ s i n^
แฟร์เท็กซ์	f xx th e k^
แมคอินทอช	m xx k^ z i n^ th @@ t^
แมคอินไตย์	m xx k^ z i n^ t a j^
แม็คโดแนลด์	m x k^ n xx l^
แม้นสมุทร	m xx n^ s a m u t^
แย้มนาม	j xx m^ n aa m^
แย้มบุญเรือง	j xx m^ b u n^ r vva ng^
แย้มวัณณังค์	j xx m^ w a n^ n a ng^
แย้มเดช	j xx m^ d ee t^
แย้มแสง	j xx m^ s xx ng^
แรงขำ	r xx ng^ kh a m^
แรนด์	r xx n^
แลง	l xx ng^
แลดิกี	l xx d i k ii
แลต	l xx t^
แลม	l xx m^
แวกประยูร	w xx k^ pr a j uu n^
แวงวรรณ	w xx ng^ w a n^
แวดาโอะ	w xx d aa z o
แวร์ซูรา	w xx s uu r aa
แวววุฒินันท์	w xx w^ w u t^ th i n a n^
แวอาแซ	w xx z aa s xx
แสงคำ	s xx ng^ kh a m^
แสงทอง	s xx ng^ th @@ ng^
แสงนภา	s xx ng^ n a ph aa
แสงนวล	s xx ng^ n uua n^
แสงนิล	s xx ng^ n i n^
แสงประทุม	s xx ng^ pr a th u m^
แสงพราว	s xx ng^ phr aa w^
แสงมรกต	s xx ng^ m @@ r a k o t^
แสงรา	s xx ng^ r aa
แสงวิเชียร	s xx ng^ w i ch iia n^
แสงศรี	s xx ng^ s ii
แสงศิริ	s xx ng^ s i r i
แสงศิลา	s xx ng^ s i l aa
แสงสนิท	s xx ng^ s a n i t^
แสงสา	s xx ng^ s aa
แสงสิงแก้ว	s xx ng^ s i ng^ k xx w^
แสงสุข	s xx ng^ s u k^
แสงสุริยะ	s xx ng^ s u r i j a
แสงสุวรรณ	s xx ng^ s u w a n^
แสงสุวรรณ์	s xx ng^ s u w a n^
แสงอร่าม	s xx ng^ z a r aa m^
แสงอะโน	s xx ng^ z a n oo
แสงอุทัย	s xx ng^ z u th a j^
แสงเงิน	s xx ng^ ng qq n^
แสงเดือนฉาย	s xx ng^ d vva n^ ch aa j^
แสงเทียน	s xx ng^ th iia n^
แสงเมือง	s xx ng^ m vva ng^
แสงโชติ	s xx ng^ ch oo t^
แสงโพธิรัตน์	s xx ng^ ph oo r a t^
แสงโพธิ์	s xx ng^ ph oo
แสนกล้า	s xx n^ kl aa
แสนตรง	s xx n^ tr o ng^
แสนทวีสุข	s xx n^ th a w ii s u k^
แสนวิเศษ	s xx n^ w i s ee t^
แสนสมบูรณ์สุข	s xx n^ s o m^ b uu n^ s u k^
แสนสุข	s xx n^ s u k^
แสนหล้า	s xx n^ l aa
แสนเจริญ	s xx n^ c a r qq n^
แสนเสน่ห์	s xx n^ s a n ee
แสนแก้ว	s xx n^ k xx w^
แสนโคต	s xx n^ kh oo t^
แหลมฟ้าผ่า	l xx m^ f aa ph aa
แหลมวิไล	l xx m^ w i l a j^
แหลมสิงห์	l xx m^ s i ng^
แหวนประดับ	w xx n^ pr a d a p^
แหวนหล่อ	w xx n^ l @@
แหวนเพชร	w xx n^ ph ee t^
แหเลิศตระกูล	h xx l qq t^ tr a k uu n^
แอน	z xx n^
แอนนิ่ง	z xx n^ n i ng^
แอนโฟเน่	z xx n^ f oo n ee
แอร์รี่	z xx r ii
แอลจียิม	z xx n^ c ii j i m^
โกกิลานนท์	k oo k i l aa n o n^
โกจิ๋ว	k oo c i w^
โกฎคำลือ	k oo d kh a m^ l vv
โกฏิมนัสวนิชย์	k oo t^ m a n a t^ s a w a n i t^
โกมลฐิติ	k oo m o n^ l a th i t i
โกมลวณิช	k oo m o n^ l a w a n i t^
โกมลวาทิน	k oo m o n^ l a w aa th i n^
โกมลเสน	k oo m o n^ l a s ee n^
โกมารทัต	k oo m aa n^ r a th a t^
โกลิมาศ	k oo l i m aa t^
โกวิทวาณิช	k oo w i t^ w aa n i t^
โกศัยสุข	k oo s a j^ s u k^
โกศิน	k oo s i n^
โกษะโยธิน	k oo s a j oo th i n^
โกสิยพงษ์	k oo s i j^ ph o ng^
โขมศิริ	kh oo m^ s i r i
โคกระบินทร์	kh oo kr a b i n^
โคตรชมพู	kh oo t^ ch o m^ ph uu
โคตรสีเมือง	kh oo t^ s ii m vva ng^
โคตรเรือง	kh oo t^ r vva ng^
โคตรเวียง	kh oo t^ w iia ng^
โคนาโล	kh oo n aa l oo
โคมฉาย	kh oo m^ ch aa j^
โคร์นิน	kh oo n i n^
โควสุรัตน์	khw oo s u r a t^
โควหกุล	kh oo w^ h a k u n^
โค๊ธนี	kh oo th a n ii
โฆวิไลกูล	kh oo w i l a j^ k uu n^
โฆษิตพิพัฒน์	kh oo s i t^ ph i ph a t^
โฆษิตานนท์	kh oo s i t aa n o n^
โง่นคำ	ng oo n^ kh a m^
โชคจินดาชัย	ch oo k^ c i n^ d aa ch a j^
โชคชนะ	ch oo k^ ch a n a
โชคชัยวัฒนากร	ch oo k^ ch a j^ w a t^ th a n aa k @@ n^
โชคประจักษ์ชัด	ch oo k^ pr a c a k^ ch a t^
โชคระดา	ch oo k^ r a d aa
โชควัฒนา	ch oo khw a t^ th a n aa
โชควิวัฒน์	ch oo k^ w i w a t^
โชคอนันต์	ch oo z a n a n^
โชคอำนวย	ch oo z a m^ n uua j^
โชติกวิน	ch oo t^ k a w i n^
โชติกุล	ch oo t i k u n^
โชติชัยชรินทร์	ch oo t^ ch a j^ ch a r i n^
โชติชูตระกูล	ch oo t^ ch uu tr a k uu n^
โชตินุชิต	ch oo t i n u ch i t^
โชติพานิช	ch oo t i ph aa n i t^
โชติพิบูลศิลป์	ch oo t^ ph i b uu n^ s i n^
โชติวิจิตร	ch oo t^ w i c i t^
โชติเลอศักดิ์	ch oo t^ l qq s a k^
โซสเซย์	s oo t^ s ee
โด	d oo
โดมพระจันทร์	d oo m^ phr a c a n^
โดริโก้	d oo r i k oo
โตคงทรัพย์	t oo kh o ng^ s a p^
โตจิราการ	t oo c i r aa k aa n^
โตวรรณเกษม	t oo w a n^ k a s ee m^
โตวิจักษณ์ชัยกุล	t oo w i c a k^ ch a j^ k u n^
โตสวัสดิ์	t oo s a w a t^
โตสิตระกูล	t oo s i tr a k uu n^
โตะตาหยง	t o t aa j o ng^
โต๊ะมีนา	t o m ii n aa
โทณะวณิก	th oo n a w a n i k^
โทนะหงษา	th oo n a h o ng^ s aa
โนนศรีชัย	n oo s ii ch a j^
โน๊ตชัยยา	n oo t^ ch a j^ j aa
โบสุวรรณ	b oo s u w a n^
โปขะรี	p oo kh a r ii
โปตระนันท์	p oo tr a n a n^
โปตะวณิช	p oo t a w a n i t^
โปลิตานนท์	p oo l i t aa n o n^
โปษยกฤต	p oo s a j a kr i t^
โปษยานนท์	p oo s a j aa n o n^
โพซิ้ว	ph oo s i w^
โพทะยะ	ph oo th a j a
โพธสุธน	ph oo th a s u th o n^
โพธารากุล	ph oo th aa r aa k u n^
โพธาราม	ph oo th aa r aa m^
โพธารามิก	ph oo th aa r aa m i k^
โพธารุ่งโรจน์	ph oo th aa r u ng^ r oo t^
โพธิจักร	ph oo c a k^
โพธิพิพิธ	ph oo ph i ph i t^
โพธิวิหค	ph oo th i w i h o k^
โพธิสาโร	ph oo th i s aa r oo
โพธิสุวรรณ	ph oo th i s u w a n^
โพธิไสย	ph oo th i s a j^
โพธิ์กระจ่าง	ph oo kr a c aa ng^
โพธิ์คง	ph oo kh o ng^
โพธิ์งาม	ph oo ng aa m^
โพธิ์ประเสริฐ	ph oo pr a s qq t^
โพธิ์ยิ้ม	ph oo j i m^
โพธิ์สุ	ph oo s u
โพธิ์สุวรรณ	ph oo s u w a n^
โพธิ์สุวรรณยิม	ph oo s u w a n^ n a j i m^
โพธิ์หาญรัตนกุล	ph oo h aa n^ r a t^ t a n a k u n^
โพธิ์อ้น	ph oo z o n^
โพธิ์เจริญ	ph oo c a r qq n^
โพธิ์เที่ยง	ph oo th iia ng^
โพธิ์เรือนดี	ph oo r vva n^ d ii
โภคกุลกานนท์	ph oo k^ k u n^ k aa n o n^
โภไคยอุดม	ph oo kh a j^ z u d o m^
โมกขะเวส	m oo k^ kh a w ee t^
โมกศรี	m oo k^ s ii
โมนยะกุล	m oo n^ j a k u n^
โมริส	m oo r i t^
โยธาพิทักษ์	j oo th aa ph i th a k^
โยธารักษ์	j oo th aa r a k^
โย้จิ้ว	j oo c i w^
โรจนทรัพย์	r oo t^ c a n a s a p^
โรจนธรรม	r oo t^ c a n a th a m^
โรจนนิล	r oo t^ c a n a n i n^
โรจนพานิช	r oo t^ c a n a ph aa n i t^
โรจนวัชร	r oo t^ c a n a w a t^ ch a r a
โรจนวุฒิธรรม	r oo t^ c a n a w u t^ th i th a m^
โรจนสุนันท์	r oo t^ c a n a s u n a n^
โรจนะหัสดิน	r oo t^ c a n a h a t^ s a d i n^
โรจนเสถียร	r oo t^ c a n a s a th iia n^
โรจน์ชีวิน	r oo t^ ch ii w i n^
โรจน์บวรวิทยา	r oo t^ b @@ w @@ r a w i t^ th a j aa
โรเจอร์	r oo c qq
โรเจอร์ส	r oo c qq
โลหนันทน์	l oo h a n a n^
โลหะวณิชย์	l oo h a w a n i t^
โลหะโชติ	l oo h a ch oo t^
โล่งสว่าง	l oo ng^ s a w aa ng^
โล่สถาพรพิพิธ	l oo s a th aa ph @@ n^ ph i ph i t^
โล่ห์คุณสมบัติ	l oo kh u n^ s o m^ b a t^
โล่ห์วีระ	l oo w ii r a
โล่ห์สุนทร	l oo s u n^ th @@ n^
โล่ห์สุวรรณ	l oo s u w a n^
โล่ห์เงิน	l oo ng qq n^
โสคำ	s oo kh a m^
โสณกุล	s oo n a k u n^
โสตถิวันวงศ์	s oo t^ th i w a n^ w o ng^
โสพิกุล	s oo ph i k u n^
โสภจารีย์	s oo ph a c aa r ii
โสภณ	s oo ph o n^
โสภณพนิช	s oo ph o n^ ph a n i t^
โสภา	s oo ph aa
โสภาพงศ์	s oo ph aa ph o ng^
โสภาพรรณ	s oo ph aa ph a n^
โหตระกิตย์	h oo tr a k i t^
โหสกุล	h oo s a k u n^
โอภากุล	z oo ph aa k u n^
โอร์มาน	z oo m aa n^
โอศิริ	z oo s i r i
โอสถศิลป์	z oo s o t^ s i n^
โอสถานนท์	z oo s a th aa n o n^
โอสถานุเคราะห์	z oo s a th aa n u khr @
โอสเตอร์ไมเยอร์	z oo s^ t qq m a j qq
โอฬาระชิน	z oo l aa r a ch i n^
โอเซกิ	z oo s ee k i
โอแกน	z oo k xx n^
โอ่ประเสริฐ	z oo pr a s qq t^
โฮชิน	h oo ch i n^
โฮร์เน่	h oo n ee
โฮเลอร์	h oo l qq
ใจกันทะ	c a j^ k a n^ th a
ใจกันทา	c a j^ k a n^ th aa
ใจจงรัก	c a j^ c o ng^ r a k^
ใจชาญสุขกิจ	c a j^ ch aa n^ s u k^ kh a k i t^
ใจชื่น	c a j^ ch vv n^
ใจซื่อกุล	c a j^ s vv k u n^
ใจดี	c a j^ d ii
ใจบำรุง	c a j^ b a m^ r u ng^
ใจบุญ	c a j^ b u n^
ใจมั่น	c a j^ m a n^
ใจสมุทร	c a j^ s a m u t^
ใจสิงห์	c a j^ s i ng^
ใจเด็ด	c a j^ d e t^
ใจเย็น	c a j^ j e n^
ใจแคล้ว	c a j^ khl xx w^
ใจแสน	c a j^ s xx n^
ใจใหญ่	c a j^ j a j^
ในรัชกาลที่	n a j^ r a t^ ch a k aa n^ th ii
ใบไม้	b a j^ m a j^
ใสกระจ่าง	s a j^ kr a c aa ng^
ใสงาม	s a j^ ng aa m^
ใสยเกื้อ	s a j^ j a k vva
ใหญ่เสมอ	j a j^ s a m qq
ใหม่คามิ	m a j^ kh aa m i
ใหม่ละออ	m a j^ l a z @@
ใหม่เมืองคอน	m a j^ m vva ng^ kh @@ n^
ไกรคุปต์	kr a kh u p^
ไกรบุตร	kr a b u t^
ไกรยูรเสน	kr a j^ j uu n^ s ee n^
ไกรฤกษ์	kr a j^ r qq k^
ไกรลาศ	kr a j^ l aa t^
ไกรวัตนุสสรณ์	k a j^ w a t^ t a n u s @@ s @@ n^
ไกรวาปี	kr a j^ w aa p ii
ไกรศรี	kr a j^ s ii
ไกรษร	k a j^ s @@ n^
ไกรสินธุ์	kr a j^ s i n^
ไกรเกรียงยุค	kr a j^ kr iia ng^ j u k^
ไกรเลิศ	kr a j^ l qq t^
ไกลถิ่น	kl a j^ th i n^
ไก่ย่างห้าดาวยิม	k a j^ j aa ng^ h aa d aa w^ j i m^
ไก่แก้ว	k a j^ k xx w^
ไข่เกษ	kh a j^ k ee t^
ไข่แก้ว	kh a j^ k xx w^
ไชยกาล	ch a j^ j a k aa n^
ไชยชนากุล	ch a j^ ch a n aa k u n^
ไชยณรุณ	ch a j^ n a r u n^
ไชยนันทน์	ch a j^ j a n a n^
ไชยประวัติ	ch a j^ pr a w a t^
ไชยปรีชาวิทย์	ch a j^ pr ii ch aa w i t^
ไชยปัญญา	ch a j^ j a p a n^ j aa
ไชยพงศ์จรัญ	ch a j^ j a ph o ng^ c a r a n^
ไชยพร	ch a j^ j a ph @@ n^
ไชยมงคล	ch a j^ j a m o ng^ kh o n^
ไชยมุสิก	ch a j^ j a m u s i k^
ไชยยศ	ch a j^ j o t^
ไชยรักษ์	ch a j^ j a r a k^
ไชยรัศมีศักดิ์	ch a j^ j a r a t^ s a m ii s a k^
ไชยรา	ch a j^ j a r aa
ไชยวงศ์เกียรติ	ch a j^ j uua ng^ k iia t^
ไชยวรรณ	ch a j^ j a w a n^
ไชยวรศิลป์	ch a j^ j a w @@ r a s i n^
ไชยวสุ	ch a j^ j a w a s u
ไชยวิสุทธิกุล	ch a j^ j a w i s u t^ th i k u n^
ไชยศรี	ch a j^ s ii
ไชยศรีษะ	ch a j^ s ii s a
ไชยศิวามงคล	ch a j^ j a s i w aa m o ng^ kh o n^
ไชยสาส์น	ch a j^ j a s aa n^
ไชยเชื้อ	ch a j^ ch vva
ไชยเดช	ch a j^ j a d ee t^
ไชยเวช	ch a j^ j a w ee t^
ไชยแสนสุข	ch a j^ j a s xx n^ s u k^
ไชยโกมล	ch a j^ j a j^ k a m o n^
ไชยโกมินทร์	ch a j^ j a k oo m i n^
ไดสตาร์ยิม	d a j^ s a t aa j i m^
ไตรบุญ	tr a j^ b u n^
ไตรพรวรกิจ	tr a j^ ph @@ w @@ r a k i t^
ไตรยสุนันท์	tr a j^ j a s u n a n^
ไตรรัตนศิริชัย	tr a j^ r a t^ t a n a s i r i ch a j^
ไตรรัตน์	tr a j^ r a t^
ไตรรัตน์ธนากุล	tr a j^ r a t^ th a n aa k u n^
ไตรวุฒิ	tr a w u t^
ไตรศิลป์	tr a s i n^
ไตรสรณกุล	tr a j^ s @@ r a n a k u n^
ไตรสุทธิวงษ์	tr a j^ s u t^ th i w o ng^
ไตรสุรัตน์	tr a j^ s u r a t^
ไตรเวคิน	tr a j^ w ee kh i n^
ไทยนิยม	th a j^ n i j o m^
ไทยมงคล	th a j^ m o ng^ kh o n^
ไทยรัตน์	th a j^ r a t^
ไทยหิรัญ	th a j^ h i r a n^
ไทยเศรษฐ์	th a j^ j a s ee t^
ไทยเหนือ	th a j^ n vva
ไทรงาม	s a j^ ng aa m^
ไทรนิ่มนวล	s a j^ n i m^ n uua n^
ไทรัฐ	th a r a t^
ไนท์	n a j^
ไบเล่	b a j^ l ee
ไปพรมราช	p a j^ phr o m^ r aa t^
ไปรพิศ	pr a j^ ph i t^
ไปใกล้	p a j^ kl a j^
ไพจิตร	ph a j^ c i t^
ไพจิตรกาญจนกุล	ph a j^ c i t^ k aa n^ c a n a k u n^
ไพทีกุล	ph a j^ th ii k u n^
ไพบูลย์	ph a j^ b uu n^
ไพรวัลย์	phr a j^ w a n^
ไพรสณฑ์	phr a j^ s o n^
ไพรอนันต์	phr a j^ z a n a n^
ไพรินทร์	ph a j^ r i n^
ไพรีรัก	ph a j^ r ii r a k^
ไพศาล	ph a j^ s aa n^
ไพศาลกุลวงศ์	ph a j^ s aa n^ k u n^ l a w o ng^
ไพโรจน์	ph a j^ r oo t^
ไฟไหล	f a j^ l a j^
ไมซิงเกอร์	m a s i ng^ k qq
ไม้กลัด	m a j^ kl a t^
ไม้วิลัย	m aa j^ w i l a j^
ไรท์	r a j^
ไรวา	r a j^ w aa
ไรวินท์	r a j^ w i n^
ไล้ทอง	l a j^ th @@ ng^
ไล้สวน	l a j^ s uua n^
ไวงาน	w a j^ ng aa n^
ไวทยางกูร	w a j^ th a j aa ng^ k uu n^
ไวทยานนท์	w a j^ th a j aa n o n^
ไวนิยมพงศ์	w a n i j o m^ ph o ng^
ไวยรัชพานิช	w a j^ j a r a t^ ph aa n i t^
ไหประโคน	h a j^ pr a kh oo n^
ไหมกัน	m a j^ k a n^
ไหวดี	w a d ii
ไอซ์เจลลิบาล์ม	z a j^ c ee l^ l i b aa m^
ไอศูรย์	z a j^ s uu n^
ไอสุรางฆ์	z a j^ s u r aa ng^
ไฮเน็ค	h a j^ n e k^
